form	lemma	POS	morph
—	—	PUNC	MORPH=empty
Amphio	amphio	NOMpro	Case=Nom|Numb=Sing|Gend=MascNeut|Deg=Pos
—	—	PUNC	MORPH=empty
Quadrupes	quadrupes1	NOMcom	Case=Nom|Numb=Sing
tardigrada	tardigradus	ADJqua	Case=Nom|Numb=Sing|Gend=Fem|Deg=Pos
agrestis	agrestis2	ADJqua	Case=Nom|Numb=Sing|Gend=MascFem|Deg=Pos
humilis	humilis	ADJqua	Case=Nom|Numb=Sing|Gend=MascFem|Deg=Pos
aspera	asper	ADJqua	Case=Abl|Numb=Sing|Gend=Fem|Deg=Pos
,	,	PUNC	MORPH=empty
capite	caput	NOMcom	Case=Abl|Numb=Sing
brevi	breuis	ADJqua	Case=Abl|Numb=Sing|Gend=Com|Deg=Pos
,	,	PUNC	MORPH=empty
cervice	ceruix	NOMcom	Case=Abl|Numb=Sing
anguina	anguinus	NOMcom	Case=Nom|Numb=Plur
,	,	PUNC	MORPH=empty
aspectu	aspectus	NOMcom	Case=Abl|Numb=Sing
truci	trux	ADJqua	Case=Abl|Numb=Sing|Gend=Com|Deg=Pos
,	,	PUNC	MORPH=empty
eviscerata	euiscero	VER	Case=Nom|Numb=Sing|Gend=Neut|Mood=Par|Tense=Perf|Voice=Pass
inanima	inanimus	ADJqua	Case=Acc|Numb=Sing|Gend=Neut|Deg=Pos
cum	cum2	PRE	MORPH=empty
animali	animal	NOMcom	Case=Abl|Numb=Sing
sono	sonus	NOMcom	Case=Abl|Numb=Sing
.	.	PUNC	MORPH=empty
—	—	PUNC	MORPH=empty
Chorus	chorus	NOMcom	Case=Nom|Numb=Sing
—	—	PUNC	MORPH=empty
Non	non	ADVneg	MORPH=empty
intellegimus	intelligo	VER	Numb=Plur|Mood=Ind|Tense=Pres|Voice=Act|Person=1
,	,	PUNC	MORPH=empty
nisi	nisi	CONsub	MORPH=empty
si	si2	CONsub	MORPH=empty
aperte	aperte	ADV	Deg=Pos
dixeris	dico2	VER	Numb=Sing|Mood=Ind|Tense=FutAnt|Voice=Act|Person=2
:	:	PUNC	MORPH=empty
ita	ita	ADV	Deg=Pos
sæptuose	saeptuose	ADV	Deg=Pos
dictio	dictio	NOMcom	Case=Nom|Numb=Sing
abs	ab	PRE	MORPH=empty
te	tu	PROper	Case=Abl|Numb=Sing
datur	do	VER	Numb=Sing|Mood=Ind|Tense=Pres|Voice=Pass|Person=3
,	,	PUNC	MORPH=empty
quod	quod2	CONsub	Numb=Sing
coniectura	coniectura	NOMcom	Case=Nom|Numb=Sing
sapiens	sapiens1	NOMcom	Case=Nom|Numb=Sing
ægre	aegre	ADV	Deg=Pos
contuit	contuo	VER	Numb=Sing|Mood=Ind|Tense=Perf|Voice=Act|Person=3
;	;	PUNC	MORPH=empty
—	—	PUNC	MORPH=empty
Amphio	amphio	NOMpro	Case=Nom|Numb=Sing|Gend=MascNeut|Deg=Pos
—	—	PUNC	MORPH=empty
testudo	testudo	NOMcom	Case=Nom|Numb=Sing
odi	odi	VER	Numb=Sing|Mood=Ind|Tense=Perf|Voice=Act|Person=1
ego	ego	PROper	Case=Nom|Numb=Sing
homines	homo	NOMcom	Case=Nom|Numb=Plur
ignava	ignauus2	ADJqua	Case=Acc|Numb=Plur|Gend=Fem|Deg=Pos
opera	opus1	NOMcom	Case=Acc|Numb=Plur
et	et2	CONcoo	MORPH=empty
philosopha	philosophus1	NOMcom	Case=Acc|Numb=Plur
sententia	sententia	NOMcom	Case=Nom|Numb=Sing
loca	locus	NOMcom	Case=Acc|Numb=Plur
horrida	horridus	ADJqua	Case=Acc|Numb=Plur|Gend=Neut|Deg=Pos
initas	initio	VER	Numb=Sing|Mood=Ind|Tense=Pres|Voice=Act|Person=2
tu	tu	PROper	Case=Nom|Numb=Sing
pascere	pasco	VER	Mood=Inf|Tense=Pres|Voice=Act
cornifrontes	cornifeo	VER	Case=Acc|Numb=Plur|Gend=MascFem
soles	sol	VER	Numb=Plur|Person=2
armentas	armentum	NOMcom	Case=Acc|Numb=Plur
.	.	PUNC	MORPH=empty
.	.	PUNC	MORPH=empty
.	.	PUNC	MORPH=empty
.	.	PUNC	MORPH=empty
.	.	PUNC	MORPH=empty
.	.	PUNC	MORPH=empty
sol	sol	NOMcom	Case=Nom|Numb=Sing
si	si2	CONsub	MORPH=empty
perpetuo	perpetuo2	ADV	Deg=Pos
siet	sum1	VER	Numb=Sing|Mood=Sub|Tense=Pres|Voice=Act|Person=3
,	,	PUNC	MORPH=empty
flammeo	flammeus	ADJqua	Case=Abl|Numb=Sing|Gend=MascNeut|Deg=Pos
vapore	uapor	NOMcom	Case=Abl|Numb=Sing
torrens	torrens1	NOMcom	Case=Nom|Numb=Sing|Gend=Com
terræ	terra	NOMcom	Case=Gen|Numb=Sing
fetum	fetus1	NOMcom	Case=Acc|Numb=Sing
exusserit	exuro	VER	Numb=Sing|Mood=Sub|Tense=Perf|Voice=Act|Person=3
;	;	PUNC	MORPH=empty
omnia	omnis	PROind	Case=Acc|Numb=Plur|Gend=Neut
nisi	nisi	CONsub	MORPH=empty
interveniat	interuenio	VER	Numb=Sing|Mood=Sub|Tense=Pres|Voice=Act|Person=3
sol	sol	NOMcom	Case=Nom|Numb=Sing
,	,	PUNC	MORPH=empty
pruina	pruina	NOMcom	Case=Nom|Numb=Plur
obriguerint	obrigesco	VER	Numb=Plur|Mood=Sub|Tense=Perf|Voice=Act|Person=3
.	.	PUNC	MORPH=empty
illuvie	illuuies	NOMcom	Case=Abl|Numb=Sing
corporis	corpus	NOMcom	Case=Gen|Numb=Sing
et	et2	CONcoo	MORPH=empty
coma	coma	NOMcom	Case=Nom|Numb=Sing
promissa	promitto	NOMcom	Case=Nom|Numb=Plur|Gend=Neut|Mood=Par|Tense=Perf|Voice=Pass
impexa	impexus	ADJqua	Case=Nom|Numb=Sing|Gend=Fem|Deg=Pos
conglomerata	conglomero	VER	Case=Nom|Numb=Sing|Gend=Fem|Mood=Par|Tense=Perf|Voice=Pass
atque	atque1	CONcoo	MORPH=empty
horrida	horridus	ADJqua	Case=Abl|Numb=Sing|Gend=Fem|Deg=Pos
.	.	PUNC	MORPH=empty
.	.	PUNC	MORPH=empty
.	.	PUNC	MORPH=empty
perdita	perditus	ADJqua	Case=Abl|Numb=Sing|Gend=Fem|Deg=Pos
inluvie	illuuies	NOMcom	Case=Abl|Numb=Sing
atque	atque1	CONcoo	MORPH=empty
insomnia	insomnium	NOMcom	Case=Nom|Numb=Plur
qua	qui2	ADVrel	Gend=Fem
te	tu	PROper	Case=Acc|Numb=Sing
adplicasti	applico	VER	Numb=Sing|Mood=Ind|Tense=Perf|Voice=Act|Person=2
tamen	tamen	ADV	Deg=Pos
ærumnis	aerumna	NOMcom	Case=Abl|Numb=Plur
obruta	obruo	VER	Numb=Sing|Gend=Fem|Mood=Par|Tense=Perf|Voice=Pass
?	?	PUNC	MORPH=empty
.	.	PUNC	MORPH=empty
.	.	PUNC	MORPH=empty
.	.	PUNC	MORPH=empty
cervicum	ceruix	NOMcom	Case=Gen|Numb=Plur
floros	florus	NOMcom	Case=Acc|Numb=Plur
dispendite	dispendo	VER	Numb=Plur|Mood=Imp|Tense=Pres|Voice=Act|Person=2
crines	crinis	NOMcom	Case=Acc|Numb=Plur
Nonne	nonne	ADVint.neg	MORPH=empty
hinc	hinc	ADV	Deg=Pos
vos	uos	PROper	Case=Acc|Numb=Plur
propere	propere	ADV	Deg=Pos
a	ab	PRE	MORPH=empty
stabulis	stabulum	NOMcom	Case=Abl|Numb=Plur
amolimini	amolior	VER	Numb=Plur|Mood=Ind|Tense=Pres|Voice=Act|Person=2
?	?	PUNC	MORPH=empty
exorto	exorior	VER	Case=Abl|Numb=Sing|Gend=MascNeut|Mood=Par|Tense=Perf|Voice=Pass
jubare	iubaro	VER	Mood=Inf|Tense=Pres|Voice=Act
noctis	nox	NOMcom	Case=Gen|Numb=Sing
decurso	decurro	VER	Case=Abl|Numb=Sing|Gend=MascNeut|Mood=Par|Tense=Perf|Voice=Pass
itinere	iter	NOMcom	Case=Abl|Numb=Sing
Sed	sed	CONcoo	MORPH=empty
cum	cum3	CONsub	MORPH=empty
animum	animus	NOMcom	Case=Acc|Numb=Sing
adtendi	attendo	VER	Mood=Inf|Tense=Pres|Voice=Pass|Person=1
ad	ad2	PRE	MORPH=empty
quærendum	quaero	VER	Case=Acc|Numb=Sing|Gend=Neut|Mood=Adj|Voice=Pass
,	,	PUNC	MORPH=empty
quid	quis1	PROint	Case=Nom|Numb=Sing|Gend=Neut
siet	sum1	VER	Numb=Sing|Mood=Sub|Tense=Pres|Voice=Act|Person=3
Salvete	salueo	VER	Numb=Plur|Mood=Imp|Tense=Pres|Voice=Act|Person=2
,	,	PUNC	MORPH=empty
gemini	geminus	ADJqua	Case=Nom|Numb=Sing|Gend=MascNeut|Deg=Pos
,	,	PUNC	MORPH=empty
mea	meus	PROpos	Case=Nom|Numb=Plur|Gend=Fem
propages	propago2	VER	Numb=Sing|Mood=Sub|Tense=Pres|Voice=Act|Person=2
sanguinis	sanguis	NOMcom	Case=Gen|Numb=Sing
!	!	PUNC	MORPH=empty
Minitabiliterque	minitabiliter	ADV	Deg=Pos
{Minitabiliterque}	que	CON	MORPH=empty
increpare	increpo	VER	Mood=Inf|Tense=Pres|Voice=Act
dictis	dictum	NOMcom	Case=Dat|Numb=Plur
saevis	saeuus	ADJqua	Case=Abl|Numb=Plur|Gend=Com|Deg=Pos
incipit	incipio	VER	Numb=Sing|Mood=Ind|Tense=Pres|Voice=Act|Person=3
.	.	PUNC	MORPH=empty
frendere	frendo	VER	Mood=Inf|Tense=Pres|Voice=Act
noctes	nox	NOMcom	Case=Acc|Numb=Plur
,	,	PUNC	MORPH=empty
misera	miser	ADJqua	Case=Nom|Numb=Plur|Gend=Fem|Deg=Pos
quas	qui1	PROrel	Case=Acc|Numb=Plur|Gend=Fem
perpessa	perpetior	VER	Case=Nom|Numb=Sing|Gend=Fem|Mood=Par|Tense=Perf|Voice=Pass
sum	sum1	VER	Numb=Sing|Mood=Ind|Tense=Pres|Voice=Act|Person=1
fruges	frux	NOMcom	Case=Nom|Numb=Plur
frendendo	frendo	VER	Case=Abl|Numb=Sing|Mood=Ger|Voice=Act
sola	solus	PROind	Case=Nom|Numb=Sing|Gend=Fem
saxi	saxum	NOMcom	Case=Gen|Numb=Sing
robore	robur	NOMcom	Case=Abl|Numb=Sing
.	.	PUNC	MORPH=empty
.	.	PUNC	MORPH=empty
.	.	PUNC	MORPH=empty
.	.	PUNC	MORPH=empty
seque	sui	PROref	Case=Acc|Numb=Sing
{seque}	que	CON	MORPH=empty
ad	ad2	PRE	MORPH=empty
ludos	ludus	NOMcom	Case=Acc|Numb=Plur
iam	iam	ADV	Deg=Pos
inde	inde	ADV	Deg=Pos
abhinc	abhinc	ADV	Deg=Pos
exerceant	exerceo	VER	Numb=Plur|Mood=Sub|Tense=Pres|Voice=Act|Person=3
quod	qui1	PROrel	Case=Acc|Numb=Sing|Gend=Neut
ego	ego	PROper	Case=Nom|Numb=Sing
inaudivi	inaudio	VER	Numb=Sing|Mood=Ind|Tense=Perf|Voice=Act|Person=1
accipite	accipio	VER	Numb=Plur|Mood=Imp|Tense=Pres|Voice=Act|Person=2
,	,	PUNC	MORPH=empty
et	et2	CONcoo	MORPH=empty
quid	quis1	PROint	Case=Nom|Numb=Sing|Gend=Neut
sit	sum1	VER	Numb=Sing|Mood=Sub|Tense=Pres|Voice=Act|Person=3
facto	facio	VER	Case=Abl|Numb=Sing
opus	opus2	NOMcom	Case=Ind
decernite	decerno	VER	Numb=Plur|Mood=Imp|Tense=Pres|Voice=Act|Person=2
.	.	PUNC	MORPH=empty
.	.	PUNC	MORPH=empty
.	.	PUNC	MORPH=empty
qui	qui1	PROrel	Case=Nom|Numb=Plur|Gend=Masc
sese	sui1	PROref	Case=Acc|Numb=Sing
†	†	PUNC	MORPH=empty
adfinem	affinis1	NOMcom	Case=Acc|Numb=Sing|Deg=Pos
†	†	PUNC	MORPH=empty
esse	sum1	VER	Mood=Inf|Tense=Pres|Voice=Act
ad	ad2	PRE	MORPH=empty
causandum	causor	VER	Case=Acc|Numb=Sing|Mood=Ger|Voice=Act
volunt	uolo3	VER	Numb=Plur|Mood=Ind|Tense=Pres|Voice=Act|Person=3
,	,	PUNC	MORPH=empty
de	de	PRE	MORPH=empty
virtute	uirtus	NOMcom	Case=Abl|Numb=Sing
is	is	PROdem	Case=Nom|Numb=Sing|Gend=Masc
ego	ego	PROper	Case=Nom|Numb=Sing
cernundi	cerno	VER	Case=Gen|Numb=Sing|Mood=Ger|Voice=Act
do	do	VER	Numb=Sing|Mood=Ind|Tense=Pres|Voice=Act|Person=1
potestatem	potestas	NOMcom	Case=Acc|Numb=Sing
omnibus	omnis	PROind	Case=Dat|Numb=Plur|Gend=Com
qui	qui1	PROrel	Case=Nom|Numb=Sing|Gend=Masc
viget	uigeo	VER	Numb=Sing|Mood=Sub|Tense=Pres|Voice=Act|Person=3
,	,	PUNC	MORPH=empty
vescatur	uescor	VER	Numb=Sing|Mood=Sub|Tense=Pres|Voice=Pass|Person=3
armis	arma	NOMcom	Case=Abl|Numb=Plur
,	,	PUNC	MORPH=empty
ut	ut4	CONsub	MORPH=empty
percipiat	percipio	VER	Numb=Sing|Mood=Sub|Tense=Pres|Voice=Act|Person=3
præmium	praemium	NOMcom	Case=Acc|Numb=Sing
an	an	ADVint	MORPH=empty
quis	quis2	PROind	Case=Nom|Numb=Sing|Gend=MascFem
est	sum1	VER	Numb=Sing|Mood=Ind|Tense=Pres|Voice=Act|Person=3
qui	qui1	PROrel	Case=Nom|Numb=Sing|Gend=Masc
te	tu	PROper	Case=Acc|Numb=Sing
esse	sum1	VER	Mood=Inf|Tense=Pres|Voice=Act
dignum	dignus	ADJqua	Case=Acc|Numb=Sing|Gend=MascNeut|Deg=Pos
quicum	qui	PROrel	Case=Abl|Numb=Sing|Gend=Com
{quicum}	cum3	CON	MORPH=empty
certetur	certo1	VER	Numb=Sing|Mood=Sub|Tense=Pres|Voice=Pass|Person=3
putet	puto	VER	Numb=Sing|Mood=Sub|Tense=Pres|Voice=Act|Person=3
?	?	PUNC	MORPH=empty
tuque	tu	PROper	Case=Nom|Numb=Sing
{tuque}	que	CON	MORPH=empty
te	tu	PROper	Case=Acc|Numb=Sing
desider	desidero	VER	Numb=Sing
e	ex	PRE	MORPH=empty
residem	reses	ADJqua	Case=Acc|Numb=Sing|Gend=MascFem|Deg=Pos
†	†	PUNC	MORPH=empty
nos	nos	PROper	Case=Acc|Numb=Plur
hic	hic2	ADV	Gend=Masc|Deg=Pos
esse	sum1	VER	Mood=Inf|Tense=Pres|Voice=Act
in	in	PRE	MORPH=empty
ma†	mai	NOMcom	Case=Abl|Numb=Sing
.	.	PUNC	MORPH=empty
.	.	PUNC	MORPH=empty
dic	dico2	VER	Numb=Sing|Mood=Imp|Tense=Pres|Voice=Act|Person=2
quid	quis1	PROint	Case=Acc|Numb=Sing|Gend=Neut
faciam	facio	VER	Numb=Sing|Mood=Sub|Tense=Pres|Voice=Act|Person=1
:	:	PUNC	MORPH=empty
quod	qui1	PROrel	Case=Acc|Numb=Sing|Gend=Neut
me	ego	PROper	Case=Acc|Numb=Sing
moneris	moneo	VER	Numb=Sing|Mood=Ind|Tense=Pres|Voice=Act|Person=2
,	,	PUNC	MORPH=empty
effectum	effectus1	NOMcom	Case=Acc|Numb=Sing
dabo	do	VER	Numb=Sing|Mood=Ind|Tense=Fut|Voice=Act|Person=1
.	.	PUNC	MORPH=empty
proloqui	proloquor	VER	Mood=Inf|Tense=Pres|Voice=Dep
nunc	nunc	ADV	Deg=Pos
pænitebunt	paeniteo	VER	Numb=Plur|Mood=Ind|Tense=Fut|Voice=Act|Person=3
libere	libere	ADV	Deg=Pos
in	in	PRE	MORPH=empty
grato	gratus	ADJqua	Case=Abl|Numb=Sing|Gend=MascNeut|Deg=Pos
ex	ex	PRE	MORPH=empty
loco	locus	NOMcom	Case=Abl|Numb=Sing
.	.	PUNC	MORPH=empty
.	.	PUNC	MORPH=empty
.	.	PUNC	MORPH=empty
.	.	PUNC	MORPH=empty
et	et2	CONcoo	MORPH=empty
aecum	aequus	ADJqua	Case=Nom|Numb=Sing|Gend=Neut|Deg=Pos
et	et2	CONcoo	MORPH=empty
rectum	rectus	ADJqua	Case=Nom|Numb=Sing|Gend=Neut|Deg=Pos
est	sum1	VER	Numb=Sing|Mood=Ind|Tense=Pres|Voice=Act|Person=3
id	is	PROdem	Case=Acc|Numb=Sing|Gend=Neut
quod	qui1	PROrel	Case=Acc|Numb=Sing|Gend=Neut
postulas	postulo	VER	Numb=Sing|Mood=Ind|Tense=Pres|Voice=Act|Person=2
:	:	PUNC	MORPH=empty
jurati	iuratus	ADJqua	Case=Nom|Numb=Plur|Gend=Masc|Deg=Pos
cernant	cerno	VER	Numb=Plur|Mood=Sub|Tense=Pres|Voice=Act|Person=3
!	!	PUNC	MORPH=empty
.	.	PUNC	MORPH=empty
.	.	PUNC	MORPH=empty
.	.	PUNC	MORPH=empty
si	si2	CONsub	MORPH=empty
non	non	ADVneg	MORPH=empty
est	sum1	VER	Numb=Sing|Mood=Ind|Tense=Pres|Voice=Act|Person=3
ingratum	ingratus	ADJqua	Case=Acc|Numb=Sing|Gend=Neut|Deg=Pos
reapse	reapsus	ADV	Deg=Pos
quod	qui1	PROrel	Case=Acc|Numb=Sing|Gend=Neut
feci	facio	VER	Numb=Sing|Mood=Ind|Tense=Perf|Voice=Act|Person=1
bene	bene	ADV	Deg=Pos
!	!	PUNC	MORPH=empty
.	.	PUNC	MORPH=empty
.	.	PUNC	MORPH=empty
.	.	PUNC	MORPH=empty
men	ego	PROper	Case=Acc
{men}	ne2	ADV	MORPH=empty
servasse	seruo	VER	Mood=Inf|Tense=Perf|Voice=Act
,	,	PUNC	MORPH=empty
ut	ut4	CONsub	MORPH=empty
essent	sum1	VER	Numb=Plur|Mood=Sub|Tense=Impa|Voice=Act|Person=3
qui	qui1	PROrel	Case=Nom|Numb=Plur|Gend=Masc
me	ego	PROper	Case=Acc|Numb=Sing
perderent	perdo	VER	Numb=Plur|Mood=Sub|Tense=Impa|Voice=Act|Person=3
?	?	PUNC	MORPH=empty
.	.	PUNC	MORPH=empty
.	.	PUNC	MORPH=empty
.	.	PUNC	MORPH=empty
feroci	ferox	ADJqua	Case=Abl|Numb=Sing|Gend=Com|Deg=Pos
ingenio	ingenium	NOMcom	Case=Abl|Numb=Sing
,	,	PUNC	MORPH=empty
torvus	toruus	ADJqua	Case=Nom|Numb=Sing|Gend=Masc|Deg=Pos
,	,	PUNC	MORPH=empty
prægrandi	praegrandis	ADJqua	Case=Gen|Numb=Sing|Gend=MascNeut|Deg=Pos
gradu	gradus	NOMcom	Case=Abl|Numb=Sing
.	.	PUNC	MORPH=empty
cum	cum3	CONsub	MORPH=empty
recordor	recordor	VER	Numb=Sing|Mood=Ind|Tense=Pres|Voice=Dep|Person=1
eius	is	PROdem	Case=Gen|Numb=Sing|Gend=Com
ferocem	ferox	ADJqua	Case=Acc|Numb=Sing|Gend=MascFem|Deg=Pos
et	et2	CONcoo	MORPH=empty
torvam	toruus	ADJqua	Case=Acc|Numb=Sing|Gend=Fem|Deg=Pos
confidentiam	confidentia	NOMcom	Case=Acc|Numb=Sing
nam	nam	CONcoo	MORPH=empty
canis	canis	NOMcom	Case=Nom|Numb=Sing
,	,	PUNC	MORPH=empty
quando	quando2	ADVint	MORPH=empty
est	sum1	VER	Numb=Sing|Mood=Ind|Tense=Pres|Voice=Act|Person=3
percussa	percutio	VER	Case=Nom|Numb=Sing|Gend=Fem|Mood=Par|Tense=Perf|Voice=Pass
lapide	lapis	NOMcom	Case=Abl|Numb=Sing
,	,	PUNC	MORPH=empty
non	non	ADVneg	MORPH=empty
tam	tam	ADV	Deg=Pos
illum	ille	PROdem	Case=Acc|Numb=Sing|Gend=Masc
adpetit	appeto	VER	Numb=Sing|Mood=Ind|Tense=Pres|Voice=Act|Person=3
qui	qui1	PROrel	Case=Nom|Numb=Sing|Gend=Masc
sese	sui1	PROref	Case=Acc|Numb=Sing
icit	ico	VER	Numb=Sing|Mood=Ind|Tense=Pres|Voice=Act|Person=3
,	,	PUNC	MORPH=empty
quam	quam1	ADVrel	MORPH=empty
illum	ille	PROdem	Case=Acc|Numb=Sing|Gend=Masc
eumpse	ispe	PROdem	Case=Nom|Numb=Sing|Gend=Masc
{eumpse}	ue	CON	MORPH=empty
lapidem	lapis	NOMcom	Case=Acc|Numb=Sing
,	,	PUNC	MORPH=empty
qui	qui1	PROrel	Case=Nom|Numb=Sing|Gend=Masc
ipsa	ipse	PROdem	Case=Nom|Numb=Sing|Gend=Fem
icta	ico	VER	Case=Nom|Numb=Sing|Gend=Fem
est	sum1	VER	Numb=Sing|Mood=Ind|Tense=Pres|Voice=Act|Person=3
petit	peto	VER	Numb=Sing|Mood=Ind|Tense=Pres|Voice=Act|Person=3
Pro	pro1	PRE	MORPH=empty
imperio	imperium	NOMcom	Case=Abl|Numb=Sing
agendum	ago	VER	Case=Nom|Numb=Sing|Gend=Neut|Mood=Adj|Voice=Pass
est	sum1	VER	Numb=Sing|Mood=Ind|Tense=Pres|Voice=Act|Person=3
.	.	PUNC	MORPH=empty
Quis	quis1	PROint	Case=Nom|Numb=Sing|Gend=MascFem
vetat	ueto	VER	Numb=Sing|Mood=Ind|Tense=Pres|Voice=Act|Person=3
,	,	PUNC	MORPH=empty
quisve	quis	PROrel	Case=Nom|Numb=Sing|Gend=Masc
{quisve}	ue	CON	MORPH=empty
attolat	attolo	VER	Numb=Sing|Mood=Ind|Tense=Pres|Voice=Act|Person=3
nunc	nunc	ADV	Deg=Pos
primum	primum	ADJadv.ord	Deg=Sup
opacat	opaco	VER	Numb=Sing|Mood=Ind|Tense=Pres|Voice=Act|Person=3
flore	flos	NOMcom	Case=Abl|Numb=Sing
lanugo	lanugo	NOMcom	Case=Abl|Numb=Sing
genas	gena	NOMcom	Case=Acc|Numb=Plur
parentum	parens1	NOMcom	Case=Gen|Numb=Plur
incertum	incertus	ADJqua	Case=Acc|Numb=Sing|Gend=MascNeut|Deg=Pos
investigandum	inuestigo	VER	Case=Acc|Numb=Sing|Gend=MascNeut|Mood=Adj|Voice=Pass
gratia	gratia	NOMcom	Case=Abl|Numb=Sing
dolet	doleo	VER	Numb=Sing|Mood=Ind|Tense=Pres|Voice=Act|Person=3
pigetque	piget	VER	Numb=Sing|Mood=Ind|Tense=Pres|Voice=Act|Person=3
{pigetque}	que	CON	MORPH=empty
magisque	magis	ADV	Deg=Comp
{magisque}	que	CON	MORPH=empty
me	ego	PROper	Case=Acc|Numb=Sing
conatum	conor	VER	Case=Acc|Numb=Sing|Mood=Par|Tense=Perf|Voice=Pass
hoc	hic1	PROdem	Case=Acc|Numb=Sing|Gend=Neut
nequiquam	nequiquam	ADV	Deg=Pos
itiner	iter	NOMcom	Case=Nom|Numb=Sing
etsi	etsi2	CONsub	MORPH=empty
metuo	metuo	VER	Numb=Sing|Mood=Ind|Tense=Pres|Voice=Act|Person=1
picta	pingo	VER	Numb=Sing|Gend=Fem|Mood=Par|Tense=Perf|Voice=Pass
de	de	PRE	MORPH=empty
plaga	plaga1	NOMcom	Case=Abl|Numb=Sing
palam	palam1	ADV	Deg=Pos
gradere	gradior	VER	Mood=Inf|Tense=Pres|Voice=Act
atque	atque1	CONcoo	MORPH=empty
atrocem	atrox	ADJqua	Case=Acc|Numb=Sing|Gend=MascFem|Deg=Pos
coerce	coerceo	VER	Numb=Sing|Mood=Imp|Tense=Pres|Voice=Act|Person=2
confidentiam	confidentia	NOMcom	Case=Acc|Numb=Sing
.	.	PUNC	MORPH=empty
.	.	PUNC	MORPH=empty
.	.	PUNC	MORPH=empty
.	.	PUNC	MORPH=empty
extremum	exter	NOMcom	Case=Acc|Numb=Sing|Gend=MascNeut|Deg=Sup
intra	intra2	PRE	MORPH=empty
camterem	camter	NOMcom	Case=Acc|Numb=Sing
ipsum	ipse	PROdem	Case=Acc|Numb=Sing|Gend=MascNeut
prægradat	praegrado	VER	Numb=Sing|Mood=Sub|Tense=Pres|Voice=Act|Person=3
Parthenopaeum	Parthenopaeus	NOMpro	Case=Acc|Numb=Sing
hic	hic1	PROdem	Case=Nom|Numb=Sing|Deg=Pos
sollicita	sollicitus	ADJqua	Case=Abl|Numb=Sing|Gend=Fem|Deg=Pos
,	,	PUNC	MORPH=empty
studio	studium	NOMcom	Case=Abl|Numb=Sing
obstupida	obstupidus	ADJqua	Case=Nom|Numb=Sing|Gend=Fem|Deg=Pos
,	,	PUNC	MORPH=empty
suspenso	suspendo	VER	Case=Abl|Numb=Sing|Gend=MascNeut|Mood=Par|Tense=Perf|Voice=Pass
animo	animus	NOMcom	Case=Abl|Numb=Sing
civitas	ciuitas	NOMcom	Case=Nom|Numb=Sing
!	!	PUNC	MORPH=empty
Quæ	quis1	PROrel	Case=Nom|Numb=Sing|Gend=Fem
ægritudo	aegritudo	NOMcom	Case=Nom|Numb=Sing
insolens	insolens	ADJqua	Case=Nom|Numb=Sing|Gend=Com|Deg=Pos
mentem	mens	NOMcom	Case=Acc|Numb=Sing
adtemptat	attento	VER	Numb=Sing|Mood=Ind|Tense=Pres|Voice=Act|Person=3
tuam	tuus	PROpos	Case=Acc|Numb=Sing|Gend=Fem
?	?	PUNC	MORPH=empty
.	.	PUNC	MORPH=empty
.	.	PUNC	MORPH=empty
.	.	PUNC	MORPH=empty
dubito	dubito	VER	Numb=Sing|Mood=Ind|Tense=Pres|Voice=Act|Person=1
quam	quis1	ADVint	Case=Acc|Numb=Sing
insistam	insisto	VER	Numb=Sing|Mood=Sub|Tense=Pres|Voice=Act|Person=1
viam	uia	NOMcom	Case=Acc|Numb=Sing
aut	aut	CONcoo	MORPH=empty
quod	quis1	PROrel	Numb=Sing|Gend=Neut
primordium	primordium	NOMcom	Case=Acc|Numb=Sing
capissam	capio2	VER	Case=Acc|Numb=Sing|Gend=Fem|Mood=Par|Tense=Perf|Voice=Pass
ad	ad2	PRE	MORPH=empty
stirpem	stirps	NOMcom	Case=Acc|Numb=Sing
exquirendum	exquiro	VER	Case=Acc|Numb=Sing|Gend=MascNeut|Mood=Adj|Voice=Pass
.	.	PUNC	MORPH=empty
.	.	PUNC	MORPH=empty
.	.	PUNC	MORPH=empty
habeo	habeo	VER	Numb=Sing|Mood=Ind|Tense=Pres|Voice=Act|Person=1
ego	ego	PROper	Case=Nom|Numb=Sing
istam	iste	PROdem	Case=Acc|Numb=Sing|Gend=Fem
qui	qui1	PROrel	Case=Nom|Numb=Sing|Gend=Masc
distinguam	distinguo	VER	Numb=Sing|Mood=Sub|Tense=Pres|Voice=Act|Person=1
inter	inter	PRE	MORPH=empty
vos	uos	PROper	Case=Acc|Numb=Plur
geminitudinem	geminitudo	NOMcom	Case=Acc|Numb=Sing
.	.	PUNC	MORPH=empty
is	is	PROdem	Case=Nom|Numb=Sing|Gend=Masc
vestrorum	uester	PROpos	Case=Gen|Numb=Plur|Gend=MascNeut
uter	uter3	PROint	Case=Nom|Numb=Sing|Gend=Masc
sit	sum1	VER	Numb=Sing|Mood=Sub|Tense=Pres|Voice=Act|Person=3
,	,	PUNC	MORPH=empty
cui	qui1	PROrel	Case=Dat|Numb=Sing|Gend=Com
signum	signum	NOMcom	Case=Nom|Numb=Sing
datum	do	VER	Case=Nom|Numb=Sing|Gend=Neut|Mood=Par|Tense=Perf|Voice=Pass
est	sum1	VER	Numb=Sing|Mood=Ind|Tense=Pres|Voice=Act|Person=3
;	;	PUNC	MORPH=empty
cette	cetro	ADV	MORPH=empty
suspensum	suspendo	VER	Case=Acc|Numb=Sing|Gend=MascNeut|Deg=Pos|Mood=Par|Tense=Perf|Voice=Pass
in	in	PRE	MORPH=empty
lævo	laeuus	ADJqua	Case=Abl|Numb=Sing|Gend=MascNeut|Deg=Pos
bracchio	brachium	NOMcom	Case=Abl|Numb=Sing
ostendo	ostendo	VER	Numb=Sing|Mood=Ind|Tense=Pres|Voice=Act|Person=1
ungulum	unguleus	NOMcom	Case=Acc|Numb=Sing
Quid	quis1	PROint	Case=Nom|Numb=Sing|Gend=Neut
istuc	istic1	PROdem	Case=Nom|Numb=Sing|Gend=Neut
est	sum1	VER	Numb=Sing|Mood=Ind|Tense=Pres|Voice=Act|Person=3
?	?	PUNC	MORPH=empty
Vultum	uultus	NOMcom	Case=Acc|Numb=Sing
alligat	alligo2	VER	Numb=Sing|Mood=Ind|Tense=Pres|Voice=Act|Person=3
quæ	qui1	PROrel	Case=Nom|Numb=Sing|Gend=Fem
tristitas	tristitas	VER	Case=Acc|Numb=Plur|Gend=Fem
?	?	PUNC	MORPH=empty
Mi	ego	PROper	Case=Voc|Numb=Sing|Gend=Masc
gnate	natus1	NOMcom	Case=Voc|Numb=Sing
,	,	PUNC	MORPH=empty
ut	ut1	ADVrel	MORPH=empty
vereor	uereor	VER	Numb=Sing|Mood=Ind|Tense=Pres|Voice=Dep|Person=1
!	!	PUNC	MORPH=empty
eloqui	eloquor	VER	Mood=Inf|Tense=Pres|Voice=Dep
,	,	PUNC	MORPH=empty
porcet	porceo	VER	Numb=Sing|Mood=Ind|Tense=Pres|Voice=Act|Person=3
pudor	pudor	NOMcom	Case=Nom|Numb=Sing
concertare	concerto1	VER	Mood=Inf|Tense=Pres|Voice=Act
ac	ac1	CONcoo	MORPH=empty
dissentire	dissentio	VER	Mood=Inf|Tense=Pres|Voice=Act
partim	partim	ADV	Deg=Pos
ac	ac1	CONcoo	MORPH=empty
da	do	VER	Numb=Sing|Mood=Imp|Tense=Pres|Voice=Act|Person=2
rursum	rursus	ADV	Deg=Pos
æquiter	aequiter	ADV	Deg=Pos
nam	nam	CONcoo	MORPH=empty
quod	qui1	PROrel	Case=Acc|Numb=Sing|Gend=Neut
conabar	conor	VER	Numb=Sing|Mood=Ind|Tense=Impa|Voice=Dep|Person=1
,	,	PUNC	MORPH=empty
cum	cum3	CONsub	MORPH=empty
interventum	interuentum	NOMcom	Case=Nom|Numb=Sing
est	sum1	VER	Numb=Sing|Mood=Ind|Tense=Pres|Voice=Act|Person=3
dicere	dico2	VER	Mood=Inf|Tense=Pres|Voice=Act
,	,	PUNC	MORPH=empty
nunc	nunc	ADV	Deg=Pos
expedibo	expedio	VER	Numb=Sing|Mood=Ind|Tense=Fut|Voice=Act|Person=1
ubi	ubi3	CONsub	MORPH=empty
ego	ego	PROper	Case=Nom|Numb=Sing
me	ego	PROper	Case=Acc|Numb=Sing
gravidam	grauidus	ADJqua	Case=Acc|Numb=Sing|Gend=Fem|Deg=Pos
sentio	sentio	VER	Numb=Sing|Mood=Ind|Tense=Pres|Voice=Act|Person=1
adgravescere	aggrauesco	VER	Mood=Inf|Tense=Pres|Voice=Act
propinquitate	propinquitas	NOMcom	Case=Abl|Numb=Sing
parti	pars	NOMcom	Case=Dat|Numb=Sing
.	.	PUNC	MORPH=empty
.	.	PUNC	MORPH=empty
.	.	PUNC	MORPH=empty
cum	cum3	CONsub	MORPH=empty
incultos	incultus2	ADJqua	Case=Acc|Numb=Plur|Gend=Masc|Deg=Pos
pervestigans	peruestigo	VER	Case=Nom|Numb=Sing|Gend=Com|Mood=Par|Tense=Pres|Voice=Act
rimarem	rimor	VER	Numb=Sing|Mood=Sub|Tense=Impa|Voice=Act|Person=1
sinus	sinus	NOMcom	Case=Acc|Numb=Plur
semper	semper	ADV	Deg=Pos
sat	satis2	ADV	Case=Ind|Deg=Pos
agere	ago	VER	Mood=Inf|Tense=Pres|Voice=Act
ut	ut4	CONsub	MORPH=empty
ne	ne4	CONsub	MORPH=empty
in	in	PRE	MORPH=empty
amore	amor	NOMcom	Case=Abl|Numb=Sing
animum	animus	NOMcom	Case=Acc|Numb=Sing
occupes	occupo2	VER	Numb=Sing|Mood=Sub|Tense=Pres|Voice=Act|Person=2
quas	qui1	PROrel	Case=Acc|Numb=Plur|Gend=Fem
famulitas	famulitas	NOMcom	Case=Nom|Numb=Sing
,	,	PUNC	MORPH=empty
vis	uis	NOMcom	Case=Nom|Numb=Sing
,	,	PUNC	MORPH=empty
egestas	egestas	NOMcom	Case=Nom|Numb=Sing
,	,	PUNC	MORPH=empty
fama	fama	NOMcom	Case=Nom|Numb=Sing
,	,	PUNC	MORPH=empty
formido	formido1	NOMcom	Case=Nom|Numb=Sing
,	,	PUNC	MORPH=empty
pavor	pauor	NOMcom	Case=Nom|Numb=Sing
Tegea	Tegea	NOMpro	Case=Abl|Numb=Sing
Arcadiæ	Arcadia	NOMpro	Case=Gen|Numb=Sing
civitas	ciuitas	NOMcom	Case=Nom|Numb=Sing
†	†	PUNC	MORPH=empty
calumina	calumen	NOMcom	Case=Nom|Numb=Plur
†	†	PUNC	MORPH=empty
antiquum	antiquus	ADJqua	Case=Acc|Numb=Sing|Gend=MascNeut|Deg=Pos
oppidum	oppidum	NOMcom	Case=Acc|Numb=Sing
triplicem	triplex	ADJqua	Case=Acc|Numb=Sing|Gend=MascFem|Deg=Pos
virili	uirilis	ADJqua	Case=Abl|Numb=Sing|Gend=Com|Deg=Pos
sexu	sexus	NOMcom	Case=Abl|Numb=Sing
partum	pario2	VER	Case=Acc|Numb=Sing|Gend=MascNeut
procreat	procreo	VER	Numb=Sing|Mood=Ind|Tense=Pres|Voice=Act|Person=3
mortem	mors	NOMcom	Case=Acc|Numb=Sing
ostentant	ostento	VER	Numb=Plur|Mood=Ind|Tense=Pres|Voice=Act|Person=3
,	,	PUNC	MORPH=empty
regno	regnum	NOMcom	Case=Abl|Numb=Sing
expellunt	expello	VER	Numb=Plur|Mood=Ind|Tense=Pres|Voice=Act|Person=3
,	,	PUNC	MORPH=empty
consanguineam	consanguineus2	ADJqua	Case=Acc|Numb=Sing|Gend=Fem|Deg=Pos
esse	sum1	VER	Mood=Inf|Tense=Pres|Voice=Act
abdicant	abdico1	VER	Numb=Plur|Mood=Ind|Tense=Pres|Voice=Act|Person=3
†	†	PUNC	MORPH=empty
regi	rex	NOMcom	Case=Dat|Numb=Sing
ut	ut1	ADVrel	MORPH=empty
memorabis	memoro	VER	Numb=Sing|Mood=Ind|Tense=Fut|Voice=Act|Person=2
†	†	PUNC	MORPH=empty
nunc	nunc	ADV	Deg=Pos
regnum	regnum	NOMcom	Case=Acc|Numb=Sing
potitur	potior	VER	Numb=Sing|Mood=Ind|Tense=Pres|Voice=Dep|Person=3
transmissu	transmissus	NOMcom	Case=Abl|Numb=Sing
patris	pater	NOMcom	Case=Gen|Numb=Sing
omnes	omnis	PROind	Case=Nom|Numb=Plur|Gend=MascFem
,	,	PUNC	MORPH=empty
qui	qui1	PROrel	Case=Nom|Numb=Plur|Gend=Masc
tamquam	tamquam1	ADVrel	MORPH=empty
nos	nos	PROper	Case=Nom|Numb=Plur
serviunt	seruio	VER	Numb=Plur|Mood=Ind|Tense=Pres|Voice=Act|Person=3
sub	sub	PRE	MORPH=empty
regno	regnum	NOMcom	Case=Abl|Numb=Sing
,	,	PUNC	MORPH=empty
callent	calleo	VER	Numb=Plur|Mood=Sub|Tense=Pres|Voice=Act|Person=3
domiti	domo	VER	Case=Gen|Numb=Plur|Gend=Masc|Mood=Par|Tense=Perf|Voice=Pass
imperium	imperium	NOMcom	Case=Acc|Numb=Sing
metuere	metuo	VER	Mood=Inf|Tense=Pres|Voice=Act
æsti	aestus	NOMcom	Case=Gen|Numb=Sing
forte	forte	ADV	Deg=Pos
ex	ex	PRE	MORPH=empty
arido	aridus	ADJqua	Case=Abl|Numb=Sing|Deg=Pos
.	.	PUNC	MORPH=empty
.	.	PUNC	MORPH=empty
.	.	PUNC	MORPH=empty
interea	interea	ADV	Deg=Pos
loci	locus	NOMcom	Case=Gen|Numb=Plur
flucti	fluco	NOMcom	Case=Nom|Numb=Plur|Gend=Masc
flaccescunt	flaccesco	VER	Numb=Plur|Mood=Ind|Tense=Pres|Voice=Act|Person=3
,	,	PUNC	MORPH=empty
silescunt	silesco	VER	Numb=Plur|Mood=Ind|Tense=Pres|Voice=Act|Person=3
venti	uentus	NOMcom	Case=Nom|Numb=Plur
mollitur	mollio	VER	Numb=Sing|Mood=Ind|Tense=Pres|Voice=Pass|Person=3
mare	mare	NOMcom	Case=Nom|Numb=Sing
idæ	Ida	NOMpro	Case=Gen|Numb=Sing
promunturium	promontorium	NOMcom	Case=Acc|Numb=Sing
quoius	qui1	PROrel	Case=Gen|Numb=Sing|Gend=Com
lingua	lingua	NOMcom	Case=Abl|Numb=Sing
in	in	PRE	MORPH=empty
altum	altum	NOMcom	Case=Acc|Numb=Sing
proicit	proicio	VER	Numb=Sing|Mood=Ind|Tense=Pres|Voice=Act|Person=3
.	.	PUNC	MORPH=empty
.	.	PUNC	MORPH=empty
.	.	PUNC	MORPH=empty
incipio	incipio	VER	Numb=Sing|Mood=Ind|Tense=Pres|Voice=Act|Person=1
saxum	saxum	NOMcom	Case=Acc|Numb=Sing
temptans	tento	VER	Case=Nom|Numb=Sing|Gend=MascFem|Mood=Par|Tense=Pres|Voice=Act
scandere	scando	VER	Mood=Inf|Tense=Pres|Voice=Act
vorticem	uertex	NOMcom	Case=Acc|Numb=Sing
,	,	PUNC	MORPH=empty
summum	superus	ADJqua	Case=Acc|Numb=Sing|Gend=MascNeut|Deg=Sup
,	,	PUNC	MORPH=empty
inde	inde	ADV	Deg=Pos
in	in	PRE	MORPH=empty
omnis	omnis	PROind	Case=Acc|Numb=Plur|Gend=MascFem
partes	pars	NOMcom	Case=Acc|Numb=Plur
prospectum	prospectus	NOMcom	Case=Acc|Numb=Sing
aucupo	aucepus	NOMcom	Case=Abl|Numb=Sing
si	si2	CONsub	MORPH=empty
qua	quis2	PROind	Case=Nom|Numb=Sing|Gend=Fem
potestur	possum1	VER	Numb=Sing|Mood=Ind|Tense=Pres|Voice=Pass|Person=3
investigari	inuestigo	VER	Mood=Inf|Tense=Pres|Voice=Pass
via	uia	NOMcom	Case=Nom|Numb=Sing
est	sum1	VER	Numb=Sing|Mood=Ind|Tense=Pres|Voice=Act|Person=3
ibi	ibi	ADV	Deg=Pos
sub	sub	PRE	MORPH=empty
eo	is	PROdem	Case=Abl|Numb=Sing|Gend=MascNeut
saxo	saxum	NOMcom	Case=Abl|Numb=Sing
penitus	penitus2	ADV	Deg=Pos
strata	sterno	VER	Case=Abl|Numb=Sing|Gend=Fem|Mood=Par|Tense=Perf|Voice=Pass
harena	arena	NOMcom	Case=Abl|Numb=Sing
ingens	ingens	ADJqua	Case=Nom|Numb=Sing|Gend=Com|Deg=Pos
specus	specus	NOMcom	Case=Nom|Numb=Sing
.	.	PUNC	MORPH=empty
.	.	PUNC	MORPH=empty
.	.	PUNC	MORPH=empty
fugimus	fugio	VER	Numb=Plur|Mood=Ind|Tense=Pres|Voice=Act|Person=1
qui	qui1	PROrel	Case=Nom|Numb=Plur|Gend=Masc
arte	ars	NOMcom	Case=Abl|Numb=Sing
hac	hic2	ADV	Case=Abl|Numb=Sing|Gend=Fem
vescimur	uescor	VER	Numb=Plur|Mood=Ind|Tense=Pres|Voice=Dep|Person=1
adiutamini	adiuto	VER	Numb=Plur|Mood=Imp|Tense=Pres|Voice=Dep|Person=2
et	et2	CONcoo	MORPH=empty
defendite	defendo	VER	Numb=Plur|Mood=Imp|Tense=Pres|Voice=Act|Person=2
atque	atque1	CONcoo	MORPH=empty
eccos	eccus	INJ	Case=Acc|Numb=Plur
unde	unde1	ADVrel	MORPH=empty
certiscent	certisco	VER	Numb=Plur|Mood=Ind|Tense=Pres|Voice=Act|Person=3
.	.	PUNC	MORPH=empty
.	.	PUNC	MORPH=empty
.	.	PUNC	MORPH=empty
inveni	inuenio	VER	Numb=Sing|Mood=Ind|Tense=Perf|Voice=Act|Person=1
,	,	PUNC	MORPH=empty
opino	opino	VER	Numb=Sing|Mood=Ind|Tense=Pres|Voice=Act|Person=1
,	,	PUNC	MORPH=empty
Orestes	Orestes	NOMpro	Case=Nom|Numb=Sing
uter	uter3	PROint	Case=Nom|Numb=Sing|Gend=Masc
esset	sum1	VER	Numb=Sing|Mood=Sub|Tense=Impa|Voice=Act|Person=3
tamen	tamen	ADV	Deg=Pos
di	deus	NOMcom	Case=Nom|Numb=Plur
monerint	moneo	VER	Numb=Plur|Mood=Sub|Tense=Perf|Voice=Act|Person=3
meliora	bonus	ADJqua	Case=Acc|Numb=Plur|Gend=Neut|Deg=Comp
atque	atque1	CONcoo	MORPH=empty
amentiam	amentia	NOMcom	Case=Acc|Numb=Sing
averruncassint	auerrunco	VER	Numb=Plur|Mood=Sub|Tense=Pqp|Voice=Act|Person=3
tuam	tuus	PROpos	Case=Acc|Numb=Sing|Gend=Fem
!	!	PUNC	MORPH=empty
pro	pro1	PRE	MORPH=empty
merenda	mereor	VER	Case=Abl|Numb=Sing|Gend=Fem|Mood=Adj|Voice=Pass
gratia	gratia	NOMcom	Case=Abl|Numb=Sing
simul	simul1	ADV	Deg=Pos
cum	cum3	CONsub	MORPH=empty
videam	uideo	VER	Numb=Sing|Mood=Sub|Tense=Pres|Voice=Act|Person=1
Graios	graius	ADJqua	Case=Acc|Numb=Plur|Gend=Masc|Deg=Pos
nihil	nihil	PROind	Case=Ind
mediocriter	mediocriter	ADV	Deg=Pos
redamptruare	redamotruo	VER	Mood=Inf|Tense=Pres|Voice=Act
opibusque	ops	NOMcom	Case=Abl|Numb=Plur
{opibusque}	que	CON	MORPH=empty
summis	superus	ADJqua	Case=Abl|Numb=Plur|Gend=Com|Deg=Sup
persequi	persequor	VER	Mood=Inf|Tense=Pres|Voice=Dep
atque	atque1	CONcoo	MORPH=empty
,	,	PUNC	MORPH=empty
ut	ut1	ADVrel	MORPH=empty
promeruit	promereo	VER	Numb=Sing|Mood=Ind|Tense=Perf|Voice=Act|Person=3
,	,	PUNC	MORPH=empty
pater	pater	NOMcom	Case=Nom|Numb=Sing
mihi	ego	PROper	Case=Dat|Numb=Sing
patriam	patria	NOMcom	Case=Acc|Numb=Sing
populavit	populo	VER	Numb=Sing|Mood=Ind|Tense=Perf|Voice=Act|Person=3
meam	meus	PROpos	Case=Acc|Numb=Sing|Gend=Fem
perque	per	PRE	MORPH=empty
{perque}	que	CON	MORPH=empty
nostram	noster	PROpos	Case=Acc|Numb=Sing|Gend=Fem
egregiam	egregius	ADJqua	Case=Acc|Numb=Sing|Gend=Fem|Deg=Pos
unanimitatem	unanimitas	NOMcom	Case=Acc|Numb=Sing
quam	qui1	PROrel	MORPH=empty
memoria	memoria	NOMcom	Case=Abl|Numb=Sing
deiugat	deiugo	VER	Numb=Sing|Mood=Ind|Tense=Pres|Voice=Act|Person=3
set	sed	CONcoo	MORPH=empty
cesso	cesso	VER	Numb=Sing|Mood=Ind|Tense=Pres|Voice=Act|Person=1
inimicitiam	inimicitia	NOMcom	Case=Acc|Numb=Sing
integrare	integro	VER	Mood=Inf|Tense=Pres|Voice=Act
.	.	PUNC	MORPH=empty
.	.	PUNC	MORPH=empty
.	.	PUNC	MORPH=empty
cives	ciuis	NOMcom	Case=Nom|Numb=Plur
,	,	PUNC	MORPH=empty
antiqui	antiquus	ADJqua	Case=Nom|Numb=Plur|Gend=Masc|Deg=Pos
amici	amicus1	NOMcom	Case=Nom|Numb=Plur
maiorum	maiores	NOMcom	Case=Gen|Numb=Plur
meum	meus	PROpos	Case=Acc|Numb=Sing|Gend=MascNeut
,	,	PUNC	MORPH=empty
consilium	consilium	NOMcom	Case=Acc|Numb=Sing
socii	socius1	NOMcom	Case=Gen|Numb=Plur
,	,	PUNC	MORPH=empty
augurium	augurium	NOMcom	Case=Acc|Numb=Sing
atque	atque1	CONcoo	MORPH=empty
extum	extus	NOMcom	Case=Acc|Numb=Sing
interpretes	interpres	NOMcom	Case=Acc|Numb=Plur
,	,	PUNC	MORPH=empty
{	{	PUNC	MORPH=empty
.	.	PUNC	MORPH=empty
.	.	PUNC	MORPH=empty
.	.	PUNC	MORPH=empty
}	}	PUNC	MORPH=empty
postquam	postquam	CONsub	MORPH=empty
prodigium	prodigium	NOMcom	Case=Acc|Numb=Sing
horriferum	horrifer	ADJqua	Case=Acc|Numb=Sing|Gend=MascNeut|Deg=Pos
,	,	PUNC	MORPH=empty
portentum	portentum	NOMcom	Case=Acc|Numb=Sing
pavos	pauus	NOMcom	Case=Acc|Numb=Plur
.	.	PUNC	MORPH=empty
.	.	PUNC	MORPH=empty
.	.	PUNC	MORPH=empty
nam	nam	CONcoo	MORPH=empty
isti	iste	PROdem	Case=Nom|Numb=Plur|Gend=Masc
qui	qui1	PROrel	Case=Nom|Numb=Plur|Gend=Masc
linguam	lingua	NOMcom	Case=Acc|Numb=Sing
avium	auis	NOMcom	Case=Gen|Numb=Plur
intellegunt	intelligo	VER	Numb=Plur|Mood=Ind|Tense=Pres|Voice=Act|Person=3
plusque	multum	ADV	Deg=Comp
{plusque}	que	CON	MORPH=empty
ex	ex	PRE	MORPH=empty
alieno	alienus2	ADJqua	Case=Abl|Numb=Sing|Gend=MascNeut|Deg=Pos
iecore	iecur	NOMcom	Case=Abl|Numb=Sing
sapiunt	sapio	VER	Numb=Plur|Mood=Ind|Tense=Pres|Voice=Act|Person=3
quam	quam1	ADVrel	MORPH=empty
ex	ex	PRE	MORPH=empty
suo	suum	NOMcom	Case=Abl|Numb=Sing|Gend=MascNeut
,	,	PUNC	MORPH=empty
magis	magis2	ADV	Deg=Comp
audiendum	audio	VER	Case=Acc|Numb=Sing|Gend=MascNeut|Mood=Adj|Voice=Pass
quam	quam1	ADVrel	MORPH=empty
auscultandum	ausculto	VER	Case=Acc|Numb=Sing|Gend=MascNeut|Mood=Adj|Voice=Pass
censeo	censeo	VER	Numb=Sing|Mood=Ind|Tense=Pres|Voice=Act|Person=1
Hoc	hic1	PROdem	Case=Acc|Numb=Sing|Gend=Neut
vide	uideo	VER	Numb=Sing|Mood=Imp|Tense=Pres|Voice=Act|Person=2
,	,	PUNC	MORPH=empty
circum	circum1	ADV	MORPH=empty
supraque	supra	PRE	Deg=Pos
{supraque}	que	CON	MORPH=empty
quod	qui1	PROrel	Case=Acc|Numb=Sing|Gend=Neut
complexu	complexus	NOMcom	Case=Abl|Numb=Sing
continet	contineo	VER	Numb=Sing|Mood=Ind|Tense=Pres|Voice=Act|Person=3
terram	terra	NOMcom	Case=Acc|Numb=Sing
;	;	PUNC	MORPH=empty
Id	is	PROdem	Case=Acc|Numb=Sing|Gend=Neut
quod	qui1	PROrel	Case=Acc|Numb=Sing|Gend=Neut
nostri	noster	PROpos	Case=Nom|Numb=Plur|Gend=MascNeut
caelum	caelum1	NOMcom	Case=Acc|Numb=Sing
memorant	memoro	VER	Numb=Plur|Mood=Ind|Tense=Pres|Voice=Act|Person=3
,	,	PUNC	MORPH=empty
Grai	Grai	NOMpro	Case=Nom|Numb=Plur
perhibent	perhibeo	VER	Numb=Plur|Mood=Ind|Tense=Pres|Voice=Act|Person=3
æthera	aether	NOMcom	Case=Acc|Numb=Plur
Solisque	sol	PROind	Case=Gen|Numb=Plur|Gend=Com
{Solisque}	que	CON	MORPH=empty
exortu	exortus	NOMcom	Case=Abl|Numb=Sing
capessit	capesso	VER	Numb=Sing|Mood=Ind|Tense=Pres|Voice=Act|Person=3
candorem	candor	NOMcom	Case=Acc|Numb=Sing
,	,	PUNC	MORPH=empty
occasu	occasus	NOMcom	Case=Abl|Numb=Sing
nigret	nigro	VER	Numb=Sing|Mood=Sub|Tense=Pres|Voice=Act|Person=3
,	,	PUNC	MORPH=empty
quidquid	quisquis1	PROrel	Case=Nom|Numb=Sing|Gend=Neut
est	sum1	VER	Numb=Sing|Mood=Ind|Tense=Pres|Voice=Act|Person=3
hoc	hic1	PROdem	Case=Acc|Numb=Sing|Gend=Neut
,	,	PUNC	MORPH=empty
omnia	omnis	PROind	Case=Acc|Numb=Plur|Gend=Neut
animat	animo	VER	Numb=Sing|Mood=Ind|Tense=Pres|Voice=Act|Person=3
,	,	PUNC	MORPH=empty
format	formo	VER	Numb=Sing|Mood=Ind|Tense=Pres|Voice=Act|Person=3
,	,	PUNC	MORPH=empty
alit	alo	VER	Numb=Sing|Mood=Ind|Tense=Pres|Voice=Act|Person=3
,	,	PUNC	MORPH=empty
auget	augeo	VER	Numb=Sing|Mood=Ind|Tense=Pres|Voice=Act|Person=3
,	,	PUNC	MORPH=empty
creat	creo	VER	Numb=Sing|Mood=Ind|Tense=Pres|Voice=Act|Person=3
sepelit	sepelio	VER	Numb=Sing|Mood=Ind|Tense=Pres|Voice=Act|Person=3
,	,	PUNC	MORPH=empty
recipitque	recipio	VER	Numb=Sing|Mood=Ind|Tense=Pres|Voice=Act|Person=3
{recipitque}	que	CON	MORPH=empty
in	in	PRE	MORPH=empty
sese	sui1	PROref	Case=Acc|Numb=Sing
omnia	omnis	PROind	Case=Acc|Numb=Plur|Gend=Neut
,	,	PUNC	MORPH=empty
omniumque	omnis	PROind	Case=Gen|Numb=Plur|Gend=Com
{omniumque}	que	CON	MORPH=empty
idemst	idem	PROdem	Case=Nom|Numb=Sing|Gend=Neut
{idemst}	sum1	VER	Numb=Sing|Mood=Ind|Tense=Pres|Voice=Act|Person=3
pater	pater	NOMcom	Case=Nom|Numb=Sing
;	;	PUNC	MORPH=empty
indidemque	indidem	ADV	Deg=Pos
{indidemque}	que	CON	MORPH=empty
eadem	idem	PROdem	Case=Nom|Numb=Plur|Gend=Neut
æque	aeque	ADV	Deg=Pos
oriuntur	orior	VER	Numb=Plur|Mood=Ind|Tense=Pres|Voice=Dep|Person=3
de	de	PRE	MORPH=empty
integro	integer	ADJqua	Case=Abl|Numb=Sing|Gend=MascNeut|Deg=Pos
atque	atque1	CONcoo	MORPH=empty
eodem	eodem	ADV	Gend=MascNeut
occidunt	occido1	VER	Numb=Plur|Mood=Ind|Tense=Pres|Voice=Act|Person=3
Mater	mater	NOMcom	Case=Nom|Numb=Sing
est	sum1	VER	Numb=Sing|Mood=Ind|Tense=Pres|Voice=Act|Person=3
terra	terra	NOMcom	Case=Nom|Numb=Sing
:	:	PUNC	MORPH=empty
ea	is	PROdem	Case=Nom|Numb=Sing|Gend=Fem
parit	pario2	VER	Numb=Sing|Mood=Ind|Tense=Pres|Voice=Act|Person=3
corpus	corpus	NOMcom	Case=Acc|Numb=Sing
animam	anima	NOMcom	Case=Acc|Numb=Sing
æther	aether	NOMcom	Case=Nom|Numb=Sing
adiugat	adiugo	VER	Numb=Sing|Mood=Ind|Tense=Pres|Voice=Act|Person=3
propemodum	propemodum	ADV	Deg=Pos
animus	animus	NOMcom	Case=Nom|Numb=Sing
conjectura	coniectura	NOMcom	Case=Abl|Numb=Sing
de	de	PRE	MORPH=empty
errore	error	NOMcom	Case=Abl|Numb=Sing
eius	is	PROdem	Case=Gen|Numb=Sing|Gend=Com
augurat	auguro	VER	Numb=Sing|Mood=Ind|Tense=Pres|Voice=Act|Person=3
ossuum	ossus	NOMcom	Case=Acc|Numb=Sing
inhumatum	inhumatus	ADJqua	Case=Acc|Numb=Sing|Gend=MascNeut|Deg=Pos
æstuosam	aestuosus	ADJqua	Case=Acc|Numb=Sing|Gend=Fem|Deg=Pos
auram	aura	NOMcom	Case=Acc|Numb=Sing
.	.	PUNC	MORPH=empty
.	.	PUNC	MORPH=empty
.	.	PUNC	MORPH=empty
delphos	Delphi	NOMpro	Case=Acc|Numb=Plur
venum	uenum	NOMcom	Case=Acc|Numb=Sing
pecus	pecus1	NOMcom	Case=Acc|Numb=Sing
egi	ago	VER	Numb=Sing|Mood=Ind|Tense=Perf|Voice=Act|Person=1
,	,	PUNC	MORPH=empty
unde	unde1	ADVrel	MORPH=empty
ad	ad2	PRE	MORPH=empty
stabula	stabulum	NOMcom	Case=Acc|Numb=Plur
hæc	hic1	PROdem	Case=Acc|Numb=Plur|Gend=Neut
itiner	iter	NOMcom	Case=Nom|Numb=Sing
contuli	confero	VER	Numb=Sing|Mood=Ind|Tense=Perf|Voice=Act|Person=1
gnatam	nata	NOMcom	Case=Acc|Numb=Sing
despondit	despondeo	VER	Numb=Sing|Mood=Ind|Tense=Perf|Voice=Act|Person=3
,	,	PUNC	MORPH=empty
nuptiis	nuptiae	NOMcom	Case=Dat|Numb=Plur
hanc	hic1	PROdem	Case=Acc|Numb=Sing|Gend=Fem
dat	do	VER	Numb=Sing|Mood=Ind|Tense=Pres|Voice=Act|Person=3
diem	dies	NOMcom	Case=Acc|Numb=Sing
hymenæum	hymenaeus	NOMcom	Case=Acc|Numb=Sing
fremunt	fremo	VER	Numb=Plur|Mood=Ind|Tense=Pres|Voice=Act|Person=3
æquales	aequalis1	NOMcom	Case=Nom|Numb=Plur|Deg=Pos
,	,	PUNC	MORPH=empty
aula	aula1	NOMcom	Case=Nom|Numb=Sing
resonit	resono1	VER	Numb=Sing|Mood=Ind|Tense=Perf|Voice=Act|Person=3
crepitu	crepitus	NOMcom	Case=Abl|Numb=Sing
musico	musicus1	NOMcom	Case=Abl|Numb=Sing
Nonne	nonne	ADVint	Deg=Pos
officium	officium	NOMcom	Case=Acc|Numb=Sing
fungar	fungor	VER	Numb=Sing|Mood=Sub|Tense=Pres|Voice=Act|Person=1
vulgi	uulgus	NOMcom	Case=Gen|Numb=Sing
,	,	PUNC	MORPH=empty
atque	atque1	CONcoo	Deg=Pos
ægre	aegre	ADV	Deg=Pos
malefactum	malefactum	NOMcom	Case=Acc|Numb=Sing
feram	fero	VER	Numb=Sing|Mood=Ind|Tense=Fut|Voice=Act|Person=1
?	?	PUNC	MORPH=empty
pater	pater	NOMcom	Case=Nom|Numb=Sing
Achivos	Achiui	NOMpro	Case=Acc|Numb=Plur
in	in	PRE	MORPH=empty
Capherei	Caphareus	NOMpro	Case=Gen|Numb=Sing
saxis	saxum	NOMcom	Case=Abl|Numb=Plur
pleros	plerus	ADJqua	Case=Acc|Numb=Plur|Gend=Masc|Deg=Pos
perdidit	perdo	VER	Numb=Sing|Mood=Ind|Tense=Perf|Voice=Act|Person=3
.	.	PUNC	MORPH=empty
.	.	PUNC	MORPH=empty
.	.	PUNC	MORPH=empty
primum	primum	ADJadv.ord	Deg=Sup
hoc	hic1	PROdem	Case=Acc|Numb=Sing|Gend=Neut
abs	ab	PRE	MORPH=empty
te	tu	PROper	Case=Acc|Numb=Sing
oro	oro	VER	Numb=Sing|Mood=Ind|Tense=Pres|Voice=Act|Person=1
,	,	PUNC	MORPH=empty
ni	ni2	CONsub	MORPH=empty
inexorabilem	inexorabilis	ADJqua	Case=Acc|Numb=Sing
Faxis	facio	VER	Numb=Sing|Mood=Ind|Tense=Pres|Voice=Act|Person=2
,	,	PUNC	MORPH=empty
ni	ni2	CONsub	MORPH=empty
turpassis	turpassus	VER	Numb=Plur|Gend=Com|Mood=Ind|Tense=Pres|Voice=Act|Person=2
vanitudine	uanitudo	NOMcom	Case=Abl|Numb=Sing
ætatem	aetas	NOMcom	Case=Acc|Numb=Sing
tuam	tuus	PROpos	Case=Acc|Numb=Sing|Gend=Fem
oro	oro	VER	Numb=Sing|Mood=Ind|Tense=Pres|Voice=Act|Person=1
,	,	PUNC	MORPH=empty
†	†	PUNC	MORPH=empty
mi	ego	PROper	Case=Dat|Numb=Sing
†	†	PUNC	MORPH=empty
ne	ne4	CONsub	MORPH=empty
flectas	flecto	VER	Numb=Sing|Mood=Sub|Tense=Pres|Voice=Act|Person=2
fandi	for	VER	Numb=Sing
me	ego	PROper	Case=Acc|Numb=Sing
prolixitudine	prolixitudo	NOMcom	Case=Abl|Numb=Sing
Si	si2	CONsub	MORPH=empty
quis	quis2	PROind	Case=Nom|Numb=Sing|Gend=MascFem
hac	hic1	PROdem	Case=Abl|Numb=Sing|Gend=Fem
me	ego	PROper	Case=Abl|Numb=Sing
oratione	oratio	NOMcom	Case=Abl|Numb=Sing
incilet	incilo	VER	Numb=Sing|Mood=Sub|Tense=Pres|Voice=Act|Person=3
,	,	PUNC	MORPH=empty
quid	quis1	PROint	Case=Acc|Numb=Sing|Gend=Neut
respondeam	respondeo	VER	Numb=Sing|Mood=Sub|Tense=Pres|Voice=Act|Person=1
?	?	PUNC	MORPH=empty
nam	nam	CONcoo	MORPH=empty
te	tu	PROper	Case=Acc|Numb=Sing
in	in	PRE	MORPH=empty
tenebrica	tenebricus	ADJqua	Case=Abl|Numb=Sing|Deg=Pos
sæpe	saepe	ADV	Deg=Pos
lacerabo	lacero	VER	Numb=Sing|Mood=Ind|Tense=Fut|Voice=Act|Person=1
fame	fames	NOMcom	Case=Abl|Numb=Sing
clausum	claudo1	VER	Case=Acc|Numb=Sing|Gend=MascNeut|Mood=Par|Tense=Perf|Voice=Pass
et	et2	CONcoo	MORPH=empty
fatigans	fatigo	VER	Case=Nom|Numb=Sing|Gend=MascFem|Mood=Par|Tense=Pres|Voice=Act
artus	artus1	NOMcom	Case=Acc|Numb=Plur
torto	torqueo	VER	Case=Abl|Numb=Sing|Gend=MascNeut|Mood=Par|Tense=Perf|Voice=Pass
distraham	distraho	VER	Numb=Sing|Mood=Ind|Tense=Fut|Voice=Act|Person=1
aut	aut	CONcoo	MORPH=empty
hic	hic1	PROdem	Case=Nom|Numb=Sing|Gend=Masc
est	sum1	VER	Numb=Sing|Mood=Ind|Tense=Pres|Voice=Act|Person=3
,	,	PUNC	MORPH=empty
aut	aut	CONcoo	MORPH=empty
hic	hic1	PROdem	MORPH=empty
adfore	assum1	VER	Mood=Par|Tense=Fut|Voice=Act
actutum	actutum	ADV	Deg=Pos
autumno	autumnus1	NOMcom	Case=Abl|Numb=Sing
quid	quis1	PROint	Case=Acc|Numb=Sing|Gend=Neut
quod	qui1	PROrel	Case=Acc|Numb=Sing|Gend=Neut
iam	iam	ADV	Deg=Pos
ei	is	PROdem	Case=Dat|Numb=Sing|Gend=Com
mihi	ego	PROper	Case=Dat|Numb=Sing
piget	piget	VER	Numb=Sing|Mood=Ind|Tense=Pres|Voice=Act|Person=3
paternum	paternus	ADJqua	Case=Acc|Numb=Sing|Gend=MascNeut|Deg=Pos
nomen	nomen	NOMcom	Case=Acc|Numb=Sing
,	,	PUNC	MORPH=empty
maternum	maternus	ADJqua	Case=Acc|Numb=Sing|Gend=MascNeut|Deg=Pos
pudet	pudeo	VER	Numb=Sing|Mood=Ind|Tense=Pres|Voice=Act|Person=3
profari	profor	VER	Mood=Inf|Tense=Pres|Voice=Dep
non	non	ADVneg	MORPH=empty
decet	decet	VER	Numb=Sing|Mood=Ind|Tense=Pres|Voice=Act|Person=3
animum	animus	NOMcom	Case=Acc|Numb=Sing
ægritudine	aegritudo	NOMcom	Case=Abl|Numb=Sing
in	in	PRE	MORPH=empty
re	res	NOMcom	Case=Abl|Numb=Sing
crepera	crepero	VER	Numb=Sing|Mood=Imp|Tense=Pres|Voice=Act|Person=2
confici	conficio	VER	Mood=Inf|Tense=Pres|Voice=Pass
utinam	utinam	ADV	Deg=Pos
nunc	nunc	ADV	Deg=Pos
matrescam	matresco	VER	Numb=Sing|Mood=Sub|Tense=Pres|Voice=Act|Person=1
ingenio	ingenium	NOMcom	Case=Abl|Numb=Sing
,	,	PUNC	MORPH=empty
ut	ut4	CONsub	MORPH=empty
meum	meus	PROpos	Case=Acc|Numb=Sing|Gend=MascNeut
patrem	pater	NOMcom	Case=Acc|Numb=Sing
ulcisci	ulciscor	VER	Mood=Inf|Tense=Pres|Voice=Dep
queam	queo	VER	Numb=Sing|Mood=Sub|Tense=Pres|Voice=Act|Person=1
!	!	PUNC	MORPH=empty
.	.	PUNC	MORPH=empty
.	.	PUNC	MORPH=empty
.	.	PUNC	MORPH=empty
extemplo	extemplo	ADV	Deg=Pos
,	,	PUNC	MORPH=empty
Ægisthi	Aegisthus	NOMpro	Case=Gen|Numb=Sing
fidem	fides2	NOMcom	Case=Acc|Numb=Sing
nuncupantes	nuncupo	VER	Case=Nom|Numb=Plur|Gend=MascFem|Mood=Par|Tense=Pres|Voice=Act
conciebunt	concieo	VER	Numb=Plur|Mood=Ind|Tense=Fut|Voice=Act|Person=3
populum	populus1	NOMcom	Case=Acc|Numb=Sing
.	.	PUNC	MORPH=empty
.	.	PUNC	MORPH=empty
.	.	PUNC	MORPH=empty
heu	heu	INJ	MORPH=empty
,	,	PUNC	MORPH=empty
non	non	ADVneg	MORPH=empty
tyrannum	tyrannus	NOMcom	Case=Acc|Numb=Sing
novi	nosco	VER	Numb=Sing|Mood=Ind|Tense=Perf|Voice=Act|Person=1
temeritudinem	temeritudo	NOMcom	Case=Acc|Numb=Sing
?	?	PUNC	MORPH=empty
.	.	PUNC	MORPH=empty
.	.	PUNC	MORPH=empty
.	.	PUNC	MORPH=empty
quidnam	quisnam	PROint	Case=Nom|Numb=Sing|Gend=Neut
autem	autem	CONcoo	MORPH=empty
hoc	hic1	PROdem	Case=Nom|Numb=Sing|Gend=Neut
soniti	sonitum	NOMcom	Case=Gen|Numb=Sing
est	sum1	VER	Numb=Sing|Mood=Ind|Tense=Pres|Voice=Act|Person=3
,	,	PUNC	MORPH=empty
quod	qui1	PROrel	Case=Acc|Numb=Sing|Gend=Neut
stridunt	strido	VER	Numb=Plur|Mood=Ind|Tense=Pres|Voice=Act|Person=3
fores	foris1	NOMcom	Case=Acc|Numb=Plur
?	?	PUNC	MORPH=empty
amplus	amplus	ADJqua	Case=Nom|Numb=Sing|Gend=Masc|Deg=Pos
,	,	PUNC	MORPH=empty
rubicundo	rubicundus	ADJqua	Case=Abl|Numb=Sing|Gend=MascNeut|Deg=Pos
colore	color	NOMcom	Case=Abl|Numb=Sing
et	et2	CONcoo	MORPH=empty
spectu	spectus	NOMcom	Case=Abl|Numb=Sing
protervo	proteruus	ADJqua	Case=Abl|Numb=Sing|Gend=MascNeut|Deg=Pos
ferox	ferox	ADJqua	Case=Nom|Numb=Sing|Gend=Com|Deg=Pos
Hicine	hic	PROdem	Case=Nom|Numb=Sing|Gend=Masc
{Hicine}	ne2	ADV	MORPH=empty
is	is	PROdem	Case=Nom|Numb=Sing|Gend=Masc
est	sum1	VER	Numb=Sing|Mood=Ind|Tense=Pres|Voice=Act|Person=3
,	,	PUNC	MORPH=empty
quem	qui1	PROrel	Case=Acc|Numb=Sing|Gend=Masc
fama	fama	NOMcom	Case=Nom|Numb=Sing
Graia	graius	ADJqua	Case=Nom|Numb=Sing|Gend=Fem|Deg=Pos
ante	ante2	PRE	MORPH=empty
omnis	omnis	PROind	Case=Acc|Numb=Plur|Gend=MascFem
nobilitat	nobilito	VER	Numb=Sing|Mood=Ind|Tense=Pres|Voice=Act|Person=3
viros	uir	NOMcom	Case=Acc|Numb=Plur
?	?	PUNC	MORPH=empty
Is	is	PROdem	Case=Nom|Numb=Sing|Gend=Masc
quis	quis1	PROint	Case=Nom|Numb=Sing|Gend=MascFem
est	sum1	VER	Numb=Sing|Mood=Ind|Tense=Pres|Voice=Act|Person=3
?	?	PUNC	MORPH=empty
—	—	PUNC	MORPH=empty
Qui	qui1	PROrel	Case=Nom|Numb=Sing|Gend=Masc
te	tu	PROper	Case=Acc|Numb=Sing
,	,	PUNC	MORPH=empty
nisi	nisi	CONsub	MORPH=empty
illum	ille	PROdem	Case=Acc|Numb=Sing|Gend=Masc
tu	tu	PROper	Case=Nom|Numb=Sing
occupas	occupo2	VER	Numb=Sing|Mood=Ind|Tense=Pres|Voice=Act|Person=2
,	,	PUNC	MORPH=empty
leto	letum	NOMcom	Case=Abl|Numb=Sing
dabit	do	VER	Numb=Sing|Mood=Ind|Tense=Fut|Voice=Act|Person=3
Unde	unde2	ADVint	MORPH=empty
exoritur	exorior	VER	Numb=Sing|Mood=Ind|Tense=Pres|Voice=Dep|Person=3
?	?	PUNC	MORPH=empty
quo	quis1	PROint	Case=Abl|Numb=Sing|Gend=MascNeut
præsidio	praesidium	NOMcom	Case=Abl|Numb=Sing
fretus	fretus2	ADJqua	Case=Nom|Numb=Sing|Gend=Masc|Deg=Pos
?	?	PUNC	MORPH=empty
auxiliis	auxilium	NOMcom	Case=Abl|Numb=Plur
quibus	qui1	PROrel	Case=Abl|Numb=Plur|Gend=Com
?	?	PUNC	MORPH=empty
Quo	quis1	PROint	Case=Abl|Numb=Sing|Gend=MascNeut
consilio	consilium	NOMcom	Case=Abl|Numb=Sing
consternatur	consterno1	VER	Numb=Sing|Mood=Ind|Tense=Pres|Voice=Pass|Person=3
?	?	PUNC	MORPH=empty
Qua	quis1	PROint	Case=Abl|Numb=Sing|Gend=Fem
vi	uis	NOMcom	Case=Abl|Numb=Sing
?	?	PUNC	MORPH=empty
Cuius	qui1	PROrel	Case=Gen|Numb=Sing|Gend=Com
copiis	copia	NOMcom	Case=Abl|Numb=Plur
?	?	PUNC	MORPH=empty
illum	ille	PROdem	Case=Acc|Numb=Sing|Gend=Masc
quæro	quaero	VER	Numb=Sing|Mood=Ind|Tense=Pres|Voice=Act|Person=1
,	,	PUNC	MORPH=empty
qui	qui1	PROrel	Case=Nom|Numb=Sing|Gend=Masc
adjutatur	adiuto	VER	Numb=Sing|Mood=Ind|Tense=Pres|Voice=Pass|Person=3
nunc	nunc	ADV	Deg=Pos
ne	ne4	CONsub	MORPH=empty
illum	ille	PROdem	Case=Acc|Numb=Sing|Gend=Masc
expectes	exspecto	VER	Numb=Sing|Mood=Sub|Tense=Pres|Voice=Act|Person=2
,	,	PUNC	MORPH=empty
quando	quando2	ADVint	MORPH=empty
amico	amicus1	NOMcom	Case=Dat|Numb=Sing
amiciter	amiciter	ADV	Deg=Pos
fecisti	facio	VER	Numb=Sing|Mood=Ind|Tense=Perf|Voice=Act|Person=2
.	.	PUNC	MORPH=empty
.	.	PUNC	MORPH=empty
.	.	PUNC	MORPH=empty
ubi	ubi2	ADVint	MORPH=empty
illic	illic2	ADV	Deg=Pos
est	sum1	VER	Numb=Sing|Mood=Ind|Tense=Pres|Voice=Act|Person=3
?	?	PUNC	MORPH=empty
me	ego	PROper	Case=Acc|Numb=Sing
miseram	miser	ADJqua	Case=Acc|Numb=Sing|Gend=Fem|Deg=Pos
!	!	PUNC	MORPH=empty
quonam	quonam	PROint	Case=Abl|Numb=Sing|Gend=MascNeut
clam	clam1	ADV	Deg=Pos
{	{	PUNC	MORPH=empty
grados	gradus	NOMcom	Case=Acc|Numb=Plur
}	}	PUNC	MORPH=empty
eliminat	elimino	VER	Numb=Sing|Mood=Ind|Tense=Pres|Voice=Act|Person=3
?	?	PUNC	MORPH=empty
.	.	PUNC	MORPH=empty
.	.	PUNC	MORPH=empty
.	.	PUNC	MORPH=empty
{	{	PUNC	MORPH=empty
ni	ni2	CONsub	MORPH=empty
}	}	PUNC	MORPH=empty
me	ego	PROper	Case=Acc|Numb=Sing
calvitur	caluor	VER	Numb=Sing|Mood=Ind|Tense=Pres|Voice=Act|Person=3
suspicio	suspicio1	NOMcom	Case=Nom|Numb=Sing
,	,	PUNC	MORPH=empty
hoc	hic1	PROdem	Case=Nom|Numb=Sing|Gend=Neut
est	sum1	VER	Numb=Sing|Mood=Ind|Tense=Pres|Voice=Act|Person=3
illud	ille	PROdem	Case=Nom|Numb=Sing|Gend=Neut
quod	qui1	PROrel	Case=Acc|Numb=Sing|Gend=Neut
fore	sum1	VER	Mood=Par|Tense=Fut|Voice=Act
occulte	occulte	ADV	Deg=Pos
Œax	oeax	NOMpro	Case=Nom|Numb=Sing
prædixit	praedico2	VER	Numb=Sing|Mood=Ind|Tense=Perf|Voice=Act|Person=3
.	.	PUNC	MORPH=empty
.	.	PUNC	MORPH=empty
.	.	PUNC	MORPH=empty
.	.	PUNC	MORPH=empty
.	.	PUNC	MORPH=empty
.	.	PUNC	MORPH=empty
ut	ut1	ADVrel	MORPH=empty
si	si2	CONsub	MORPH=empty
ita	ita	ADV	Deg=Pos
sunt	sum1	VER	Numb=Plur|Mood=Ind|Tense=Pres|Voice=Act|Person=3
promerita	promeritum	NOMcom	Case=Acc|Numb=Plur
vestra	uester	PROpos	Case=Acc|Numb=Plur|Gend=Neut
,	,	PUNC	MORPH=empty
æquiperare	aequipero	VER	Mood=Inf|Tense=Pres|Voice=Act
ut	ut4	CONsub	MORPH=empty
queam	queo	VER	Numb=Sing|Mood=Sub|Tense=Pres|Voice=Act|Person=1
vereor	uereor	VER	Numb=Sing|Mood=Ind|Tense=Pres|Voice=Dep|Person=1
,	,	PUNC	MORPH=empty
nisi	nisi	CONsub	MORPH=empty
numquam	numquam	ADVneg	MORPH=empty
fatiscar	fatiscor	VER	Numb=Sing|Mood=Sub|Tense=Pres|Voice=Dep|Person=1
facere	facio	VER	Mood=Inf|Tense=Pres|Voice=Act
quod	qui1	PROrel	Case=Acc|Numb=Sing|Gend=Neut
quibo	queo	VER	Numb=Sing|Mood=Ind|Tense=Pres|Voice=Act|Person=1
boni	bonus	ADJqua	Case=Gen|Numb=Sing|Gend=Masc|Deg=Pos
Macte	mactus	ADJqua	Case=Voc|Numb=Plur
esto	sum1	VER	Numb=Sing|Mood=Imp|Tense=Fut|Voice=Act|Person=2
virtute	uirtus	NOMcom	Case=Abl|Numb=Sing
,	,	PUNC	MORPH=empty
operaque	opera	NOMcom	Case=Abl|Numb=Sing
{operaque}	que	CON	MORPH=empty
!	!	PUNC	MORPH=empty
omenque	omen	NOMcom	Case=Acc|Numb=Sing
{omenque}	que	CON	MORPH=empty
adprobo	approbo	VER	Case=Abl|Numb=Sing|Gend=MascNeut|Mood=Ind|Tense=Pres|Voice=Act
responsa	responsum	NOMcom	Case=Acc|Numb=Plur
explanat	explano	VER	Numb=Sing|Mood=Ind|Tense=Pres|Voice=Act|Person=3
:	:	PUNC	MORPH=empty
mandat	mando2	VER	Numb=Sing|Mood=Ind|Tense=Pres|Voice=Act|Person=3
ne	ne4	CONsub	MORPH=empty
matri	mater	NOMcom	Case=Dat|Numb=Sing
fuat	sum1	VER	Numb=Sing|Mood=Sub|Tense=Pres|Voice=Act|Person=3
cognoscendi	cognosco	VER	Case=Gen|Numb=Sing|Mood=Ger|Voice=Act
umquam	umquam	ADV	Deg=Pos
aut	aut	CONcoo	MORPH=empty
contuendi	contueor	VER	Case=Gen|Numb=Sing|Mood=Ger|Voice=Act
copia	copia	NOMcom	Case=Nom|Numb=Sing
set	sed	CONcoo	MORPH=empty
med	ego	PROper	Case=Acc|Numb=Sing
}	}	PUNC	MORPH=empty
incertat	incerto1	VER	Numb=Sing|Mood=Ind|Tense=Pres|Voice=Act|Person=3
dictio	dictio	NOMcom	Case=Nom|Numb=Sing
—	—	PUNC	MORPH=empty
quare	quare2	ADVint	MORPH=empty
?	?	PUNC	MORPH=empty
expedi	expedio	VER	Mood=Inf|Tense=Pres|Voice=Pass|Person=2
!	!	PUNC	MORPH=empty
nihil	nihil	PROind	Case=Ind
conjectura	coniectura	NOMcom	Case=Abl|Numb=Sing
quivi	quiuis	CONsub	MORPH=empty
interpretarier	interpretor	VER	Mood=Inf|Tense=Pres|Voice=Dep
,	,	PUNC	MORPH=empty
quorsum	quorsum	ADVint	MORPH=empty
†	†	PUNC	MORPH=empty
flexivice	flexiuix	NOMcom	Case=Abl|Numb=Sing
contenderet	contendo	VER	Numb=Sing|Mood=Sub|Tense=Impa|Voice=Act|Person=3
vel	uel2	CONcoo	MORPH=empty
cum	cum3	CONsub	MORPH=empty
illum	ille	PROdem	Case=Acc|Numb=Sing|Gend=Masc
videas	uideo	VER	Numb=Sing|Mood=Sub|Tense=Pres|Voice=Act|Person=2
sollicitum	sollicitus	ADJqua	Case=Acc|Numb=Sing|Gend=MascNeut|Deg=Pos
orbitudine	orbitudo	NOMcom	Case=Abl|Numb=Sing
nec	nec2	CONcoo	MORPH=empty
grandiri	grandior	VER	Mood=Inf|Tense=Pres|Voice=Pass
frugum	frux	NOMcom	Case=Gen|Numb=Plur
fetum	fetus1	NOMcom	Case=Acc|Numb=Sing
posse	possum1	VER	Mood=Inf|Tense=Pres|Voice=Act
nec	nec2	CONcoo	MORPH=empty
mitiscere	mitisco	VER	Mood=Inf|Tense=Pres|Voice=Act
animum	animus	NOMcom	Case=Acc|Numb=Sing
quæ	qui1	PROrel	Case=Acc|Numb=Plur|Gend=Fem
{	{	PUNC	MORPH=empty
et	et2	CONcoo	MORPH=empty
}	}	PUNC	MORPH=empty
obnoxium	obnoxius	ADJqua	Case=Acc|Numb=Sing|Gend=Neut|Deg=Pos
esse	sum1	VER	Mood=Inf|Tense=Pres|Voice=Act
aut	aut	CONcoo	MORPH=empty
brutum	brutus	ADJqua	Case=Acc|Numb=Sing|Gend=MascNeut|Deg=Pos
aut	aut	CONcoo	MORPH=empty
elinguem	elinguis	ADJqua	Case=Acc|Numb=Sing|Deg=Pos
putes	puto	VER	Numb=Sing|Mood=Sub|Tense=Pres|Voice=Act|Person=2
.	.	PUNC	MORPH=empty
.	.	PUNC	MORPH=empty
.	.	PUNC	MORPH=empty
regni	regnum	NOMcom	Case=Gen|Numb=Sing
alieni	alienus2	ADJqua	Case=Gen|Numb=Sing|Gend=MascNeut|Deg=Pos
cupiditas	cupiditas	NOMcom	Case=Nom|Numb=Sing
pellexit	pellicio	VER	Numb=Sing|Mood=Ind|Tense=Perf|Voice=Act|Person=3
par	par2	ADJqua	Case=Nom|Numb=Sing|Gend=Com|Deg=Pos
fortitudo	fortitudo	NOMcom	Case=Nom|Numb=Sing
,	,	PUNC	MORPH=empty
gemina	geminus	ADJqua	Case=Abl|Numb=Sing|Gend=Fem|Deg=Pos
confidentia	confidentia	NOMcom	Case=Nom|Numb=Sing
Nam	nam	CONcoo	MORPH=empty
solus	solus	PROind	Case=Nom|Numb=Sing|Gend=Masc
Danais	Danae	NOMpro	Case=Dat|Numb=Plur
hic	hic1	PROdem	Case=Nom|Numb=Sing
domutionem	domutio	NOMcom	Case=Acc|Numb=Sing
dedit	do	VER	Numb=Sing|Mood=Ind|Tense=Perf|Voice=Act|Person=3
Quid	quis1	PROint	Case=Acc|Numb=Sing|Gend=Neut
benefacta	benefactum	NOMcom	Case=Acc|Numb=Plur
mei	meus	PROpos	Case=Gen|Numb=Sing|Gend=MascNeut
patris	pater	NOMcom	Case=Gen|Numb=Sing
,	,	PUNC	MORPH=empty
cuius	qui1	PROrel	Case=Gen|Numb=Sing|Gend=Com
opera	opus1	NOMcom	Case=Nom|Numb=Plur
te	tu	PROper	Case=Acc|Numb=Sing
esse	sum1	VER	Mood=Inf|Tense=Pres|Voice=Act
ultum	ulciscor	VER	MORPH=empty
autumant	autumo	VER	Numb=Plur|Mood=Ind|Tense=Pres|Voice=Act|Person=3
?	?	PUNC	MORPH=empty
.	.	PUNC	MORPH=empty
.	.	PUNC	MORPH=empty
.	.	PUNC	MORPH=empty
quo	quo3	ADVint	MORPH=empty
tamen	tamen	ADV	Deg=Pos
ipsa	ipse	PROdem	Case=Nom|Numb=Sing|Gend=Fem
orbitas	orbitas	NOMcom	Case=Nom|Numb=Sing
grandævitasque	grandaeuitas	NOMcom	Case=Nom|Numb=Sing
{grandævitasque}	que	CON	MORPH=empty
Pelei	Peleus	NOMpro	Case=Gen|Numb=Sing
penuriam	penuria	NOMcom	Case=Acc|Numb=Sing
stirpis	stirps	NOMcom	Case=Gen|Numb=Sing
†	†	PUNC	MORPH=empty
subaxet	subaxo	VER	Numb=Sing|Mood=Sub|Tense=Pres|Voice=Act|Person=3
†	†	PUNC	MORPH=empty
.	.	PUNC	MORPH=empty
.	.	PUNC	MORPH=empty
.	.	PUNC	MORPH=empty
sermonem	sermo	NOMcom	Case=Acc|Numb=Sing
hic	hic1	PROdem	Case=Nom|Numb=Sing|Gend=Masc
nostrum	nos	PROpos	Case=Nom|Numb=Sing|Gend=MascNeut
ex	ex	PRE	MORPH=empty
occulto	occultum	NOMcom	Case=Abl|Numb=Sing
clepsit	clepo	VER	Numb=Sing|Mood=Ind|Tense=Perf|Voice=Act|Person=3
,	,	PUNC	MORPH=empty
quantum	quantum1	PROrel	Case=Acc|Numb=Sing|Gend=MascNeut
intellego	intelligo	VER	Numb=Sing|Mood=Ind|Tense=Pres|Voice=Act|Person=1
quod	qui1	PROrel	Case=Acc|Numb=Sing|Gend=Neut
ego	ego	PROper	Case=Nom|Numb=Sing
in	in	PRE	MORPH=empty
acie	acies	NOMcom	Case=Abl|Numb=Sing
crebro	crebro2	ADV	Deg=Pos
objectans	obiecto	VER	Case=Nom|Numb=Sing|Gend=Com|Mood=Par|Tense=Pres|Voice=Act
vitam	uita	NOMcom	Case=Acc|Numb=Sing
bellando	bello	VER	Case=Abl|Numb=Sing|Mood=Ger|Voice=Act
aptus	aptus	ADJqua	Case=Nom|Numb=Sing|Gend=Masc|Deg=Pos
sum	sum1	VER	Numb=Sing|Mood=Ind|Tense=Pres|Voice=Act|Person=1
prius	prius	ADJadv.ord	Deg=Comp
data	do	VER	Case=Nom|Numb=Sing|Gend=Fem|Mood=Par|Tense=Perf|Voice=Pass
est	sum1	VER	Numb=Sing|Mood=Ind|Tense=Pres|Voice=Act|Person=3
quam	quam1	ADVrel	Gend=Fem
tibi	tu	PROper	Case=Dat|Numb=Sing
dari	do	VER	Mood=Inf|Tense=Pres|Voice=Pass
dicta	dico2	NOMcom	Case=Nom|Numb=Plur
,	,	PUNC	MORPH=empty
aut	aut	CONcoo	MORPH=empty
quam	quam1	ADVrel	Numb=Sing|Gend=Fem
reditum	reditus	NOMcom	Case=Nom|Numb=Sing
est	sum1	VER	Numb=Sing|Mood=Ind|Tense=Pres|Voice=Act|Person=3
Pergamo	Pergamum	NOMpro	Case=Abl|Numb=Sing
habet	habeo	VER	Numb=Sing|Mood=Ind|Tense=Pres|Voice=Act|Person=3
hoc	hic1	PROdem	Case=Nom|Numb=Sing|Gend=Neut
senectus	senectus1	NOMcom	Case=Nom|Numb=Sing
ipsa	ipse	PROdem	Case=Nom|Numb=Sing|Gend=Fem
in	in	PRE	MORPH=empty
se	sui1	PROref	Case=Acc|Numb=Sing
{	{	PUNC	MORPH=empty
se	sui1	PROref	Case=Acc|Numb=Sing
}	}	PUNC	MORPH=empty
,	,	PUNC	MORPH=empty
cum	cum2	PRE	MORPH=empty
pigra	piger	ADJqua	Case=Nom|Numb=Sing|Gend=Fem|Deg=Pos
est	sum1	VER	Numb=Sing|Mood=Ind|Tense=Pres|Voice=Act|Person=3
,	,	PUNC	MORPH=empty
spisse	spisse	VER	Mood=Inf|Tense=Pres|Voice=Act
ut	ut4	CONsub	MORPH=empty
videantur	uideo	VER	Numb=Plur|Mood=Sub|Tense=Pres|Voice=Pass|Person=3
omnia	omnis	PROind	Case=Acc|Numb=Plur|Gend=Neut
{	{	PUNC	MORPH=empty
ei	is	PROdem	Case=Dat|Numb=Sing|Gend=Com
}	}	PUNC	MORPH=empty
confieri	confio	VER	Mood=Inf|Tense=Pres|Voice=Pass
.	.	PUNC	MORPH=empty
.	.	PUNC	MORPH=empty
.	.	PUNC	MORPH=empty
Tyndareo	Tyndareus	NOMpro	Case=Dat|Numb=Sing
fieri	fio	VER	Mood=Inf|Tense=Pres|Voice=Act
contumeliam	contumelia	NOMcom	Case=Acc|Numb=Sing
,	,	PUNC	MORPH=empty
cuius	qui1	PROrel	Case=Gen|Numb=Sing|Gend=Com
a	ab	PRE	MORPH=empty
te	tu	PROper	Case=Abl|Numb=Sing
veretur	uereor	VER	Numb=Sing|Mood=Sub|Tense=Pres|Voice=Dep|Person=3
maxume	magis2	ADV	Deg=Sup
non	non	ADVneg	MORPH=empty
tu	tu	PROper	Case=Nom|Numb=Sing
te	tu	PROper	Case=Acc|Numb=Sing
e	ex	PRE	MORPH=empty
conspectu	conspectus1	NOMcom	Case=Abl|Numb=Sing
hinc	hinc	ADV	Deg=Pos
amolire	amolior	VER	Mood=Inf|Tense=Pres|Voice=Act
.	.	PUNC	MORPH=empty
.	.	PUNC	MORPH=empty
.	.	PUNC	MORPH=empty
tristia	tristis	ADJqua	Case=Nom|Numb=Plur|Gend=Neut|Deg=Pos
atque	atque1	CONcoo	MORPH=empty
animi	animus	NOMcom	Case=Gen|Numb=Sing
intoleranda	intolerandus	ADJqua	Case=Abl|Numb=Sing|Gend=Fem|Deg=Pos
anxitudine	anxitudo	NOMcom	Case=Abl|Numb=Sing
cum	cum3	CONsub	MORPH=empty
neque	neque	CONcoo	MORPH=empty
me	ego	PROper	Case=Acc|Numb=Sing
aspicere	aspicio	VER	Mood=Inf|Tense=Pres|Voice=Act
æquales	aequalis1	NOMcom	Case=Nom|Numb=Plur
dignarent	digno	VER	Numb=Plur|Mood=Sub|Tense=Impa|Voice=Act|Person=3
meæ	meus	PROpos	Case=Nom|Numb=Plur|Gend=Fem
.	.	PUNC	MORPH=empty
.	.	PUNC	MORPH=empty
.	.	PUNC	MORPH=empty
sub	sub	PRE	MORPH=empty
judicio	iudicium	NOMcom	Case=Abl|Numb=Sing
quæ	qui1	PROrel	Case=Nom|Numb=Plur|Gend=Fem
omnes	omnis	PROind	Case=Acc|Numb=Plur|Gend=MascFem
tetinerim	tango	VER	Numb=Sing|Mood=Sub|Tense=Perf|Voice=Act|Person=1
grados	gradus	NOMcom	Case=Acc|Numb=Plur
quantamque	quantus	PROint	Case=Acc|Numb=Sing|Gend=Fem
{quantamque}	que	CON	MORPH=empty
ex	ex	PRE	MORPH=empty
discorditate	discorditas	NOMcom	Case=Abl|Numb=Sing
cladem	clades	NOMcom	Case=Acc|Numb=Sing
inportem	importo	ADJqua	Case=Acc|Numb=Sing|Deg=Pos
familiæ	familia	NOMcom	Case=Gen|Numb=Sing
?	?	PUNC	MORPH=empty
lamentas	lamenta	NOMcom	Case=Acc|Numb=Plur
fletus	fletus	NOMcom	Case=Acc|Numb=Plur
facere	facio	VER	Mood=Inf|Tense=Pres|Voice=Act
conpendi	compendo	VER	Numb=Sing|Mood=Inf|Tense=Pres|Voice=Pass
licet	licet3	CONsub	Numb=Sing|Person=3
paucis	paucus	NOMcom	Case=Abl|Numb=Plur|Gend=Com|Deg=Pos
absolvit	absoluo	VER	Numb=Sing|Mood=Ind|Tense=Perf|Voice=Act|Person=3
,	,	PUNC	MORPH=empty
ne	ne4	CONsub	MORPH=empty
moraret	moror1	VER	Numb=Sing|Mood=Sub|Tense=Impa|Voice=Act|Person=3
diutius	diu	ADV	Deg=Comp
currum	currus	NOMcom	Case=Acc|Numb=Sing
liquit	linquo	VER	Numb=Sing|Mood=Ind|Tense=Perf|Voice=Act|Person=3
,	,	PUNC	MORPH=empty
clamide	clames	ADV	Case=Abl|Numb=Sing
contorta	contorqueo	VER	Case=Abl|Numb=Sing|Gend=Fem|Mood=Par|Tense=Perf|Voice=Pass
astu	astus	NOMcom	Case=Abl|Numb=Sing
clupeat	clupeo	VER	Numb=Sing|Mood=Sub|Tense=Pres|Voice=Act|Person=3
bracchium	brachium	NOMcom	Case=Acc|Numb=Sing
Ibo	eo1	VER	Numb=Sing|Mood=Ind|Tense=Fut|Voice=Act|Person=1
atque	atque1	CONcoo	MORPH=empty
edicam	edico2	VER	Numb=Sing|Mood=Ind|Tense=Fut|Voice=Act|Person=1
,	,	PUNC	MORPH=empty
frequentes	frequens	ADJqua	Case=Nom|Numb=Plur|Gend=MascFem|Deg=Pos
ut	ut4	CONsub	MORPH=empty
eant	eo1	VER	Numb=Plur|Mood=Sub|Tense=Pres|Voice=Act|Person=3
gratatum	grator	VER	Case=Acc|Numb=Sing|Gend=MascNeut|Deg=Pos
hospiti	hospes	NOMcom	Case=Dat|Numb=Sing
concorditatem	concorditas	NOMcom	Case=Acc|Numb=Sing
hospitio	hospitium	NOMcom	Case=Abl|Numb=Sing
adjunctam	adiungo	VER	Case=Acc|Numb=Sing|Gend=Fem|Mood=Par|Tense=Perf|Voice=Pass
perpetem	perpes	VER	Case=Acc|Numb=Sing|Deg=Pos
probitate	probitas	NOMcom	Case=Abl|Numb=Sing
conservetis	conseruo	VER	Numb=Plur|Mood=Sub|Tense=Pres|Voice=Act|Person=2
hoc	hic1	PROdem	Case=Nom|Numb=Sing|Gend=Neut
flexanima	flexanimus	ADJqua	Case=Nom|Numb=Sing|Gend=Fem|Deg=Pos
atque	atque1	CONcoo	MORPH=empty
omnium	omnis	PROind	Case=Gen|Numb=Plur|Gend=Com
regina	regina	NOMcom	Case=Nom|Numb=Sing
rerum	res	NOMcom	Case=Gen|Numb=Plur
oratio	oratio	NOMcom	Case=Nom|Numb=Sing
!	!	PUNC	MORPH=empty
.	.	PUNC	MORPH=empty
.	.	PUNC	MORPH=empty
.	.	PUNC	MORPH=empty
aut	aut	CONcoo	MORPH=empty
non	non	ADVneg	MORPH=empty
cernam	cerno	VER	Numb=Sing|Mood=Sub|Tense=Pres|Voice=Act|Person=1
,	,	PUNC	MORPH=empty
nisi	nisi	CONsub	MORPH=empty
tagam	tago	VER	Numb=Sing|Mood=Sub|Tense=Pres|Voice=Act|Person=1
quas	qui1	PROrel	Case=Acc|Numb=Plur|Gend=Fem
gloria	gloria	NOMcom	Case=Nom|Numb=Sing
et	et2	CONcoo	MORPH=empty
{	{	PUNC	MORPH=empty
.	.	PUNC	MORPH=empty
.	.	PUNC	MORPH=empty
.	.	PUNC	MORPH=empty
refutant	refuto	VER	Numb=Plur|Mood=Ind|Tense=Pres|Voice=Act|Person=3
.	.	PUNC	MORPH=empty
.	.	PUNC	MORPH=empty
.	.	PUNC	MORPH=empty
va	ua	INJ	Case=Nom|Numb=Sing
}	}	PUNC	MORPH=empty
rietas	rietas	NOMcom	Case=Nom|Numb=Sing
humanum	humanus	ADJqua	Case=Nom|Numb=Sing|Gend=Neut|Deg=Pos
ab	ab	PRE	MORPH=empty
eo	is	PROdem	Case=Abl|Numb=Sing|Gend=MascNeut
{	{	PUNC	MORPH=empty
.	.	PUNC	MORPH=empty
.	.	PUNC	MORPH=empty
.	.	PUNC	MORPH=empty
}	}	PUNC	MORPH=empty
depulsum	depello	VER	Case=Acc|Numb=Sing|Gend=Neut|Mood=Par|Tense=Perf|Voice=Pass
mamma	mamma	NOMcom	Case=Abl|Numb=Sing
pædagogandum	paedagogo	VER	Case=Acc|Numb=Sing|Gend=MascNeut|Mood=Adj|Voice=Pass
accipit	accipio	VER	Numb=Sing|Mood=Ind|Tense=Pres|Voice=Act|Person=3
repotialis	repotialis	ADJqua	Case=Nom|Numb=Sing|Gend=MascFem|Deg=Pos
Liber	liber1	NOMcom	Case=Nom|Numb=Sing|Gend=Masc|Deg=Pos
sed	sed	CONcoo	MORPH=empty
hi	hic1	PROdem	Case=Nom|Numb=Plur|Gend=Masc
cluentur	clueo	VER	Numb=Plur|Mood=Ind|Tense=Pres|Voice=Pass|Person=3
hospitum	hospes	NOMcom	Case=Gen|Numb=Plur
infid	infidus	NOMcom	Case=Nom|Numb=Sing
{	{	PUNC	MORPH=empty
e	ex	PRE	MORPH=empty
}	}	PUNC	MORPH=empty
lissimi	lissimum	ADJqua	Case=Gen|Numb=Plur|Gend=Masc|Deg=Sup
.	.	PUNC	MORPH=empty
.	.	PUNC	MORPH=empty
.	.	PUNC	MORPH=empty
blandam	blandus	ADJqua	Case=Acc|Numb=Sing|Gend=Fem|Deg=Pos
hortatricem	hortatrix	NOMcom	Case=Acc|Numb=Sing
adjugat	adiugo	VER	Numb=Sing|Mood=Ind|Tense=Pres|Voice=Act|Person=3
voluptatem	uoluptas	NOMcom	Case=Acc|Numb=Sing
Mater	mater	NOMcom	Case=Nom|Numb=Sing
,	,	PUNC	MORPH=empty
te	tu	PROper	Case=Acc|Numb=Sing
appello	appello1	VER	Numb=Sing|Mood=Ind|Tense=Pres|Voice=Act|Person=1
;	;	PUNC	MORPH=empty
tu	tu	PROper	Case=Nom|Numb=Sing
,	,	PUNC	MORPH=empty
quæ	qui1	PROrel	Case=Nom|Numb=Sing|Gend=Fem
curam	cura	NOMcom	Case=Acc|Numb=Sing
somno	somnus	NOMcom	Case=Abl|Numb=Sing
suspensam	suspensus	VER	Case=Acc|Numb=Sing|Gend=Fem|Mood=Par|Tense=Perf|Voice=Pass
levas	leuo1	VER	Numb=Sing|Mood=Sub|Tense=Pres|Voice=Act|Person=2
neque	neque	CONcoo	MORPH=empty
te	tu	PROper	Case=Acc|Numb=Sing
mei	ego	PROper	Case=Gen|Numb=Sing|Gend=MascNeut
miseret	misereo	VER	Numb=Sing|Mood=Ind|Tense=Pres|Voice=Act|Person=3
,	,	PUNC	MORPH=empty
surge	surgo	VER	Numb=Sing|Mood=Imp|Tense=Pres|Voice=Act|Person=2
et	et2	CONcoo	MORPH=empty
sepeli	sepelio	VER	Mood=Inf|Tense=Pres|Voice=Pass
natum	nascor	VER	Case=Acc|Numb=Sing
{	{	PUNC	MORPH=empty
.	.	PUNC	MORPH=empty
.	.	PUNC	MORPH=empty
.	.	PUNC	MORPH=empty
}	}	PUNC	MORPH=empty
prius	prius	ADJadv.ord	Deg=Comp
quam	quam1	ADVrel	MORPH=empty
feræ	fera	NOMcom	Case=Nom|Numb=Plur
volucresque	uolucer	NOMcom	Case=Acc|Numb=Plur
{volucresque}	que	CON	MORPH=empty
{	{	PUNC	MORPH=empty
.	.	PUNC	MORPH=empty
.	.	PUNC	MORPH=empty
.	.	PUNC	MORPH=empty
}	}	PUNC	MORPH=empty
neu	neue2	CONsub	MORPH=empty
reliquias	reliquiae	NOMcom	Case=Acc|Numb=Plur
semesas	semesus	ADJqua	Case=Acc|Numb=Plur|Gend=Fem|Deg=Pos
sireis	sireus	ADJqua	Case=Abl|Numb=Plur|Gend=Com|Deg=Pos
denudatis	denudo	VER	Case=Abl|Numb=Plur|Gend=Com|Mood=Par|Tense=Perf|Voice=Pass
ossibus	os2	NOMcom	Case=Abl|Numb=Plur
per	per	PRE	MORPH=empty
terram	terra	NOMcom	Case=Acc|Numb=Sing
sanie	sanies	NOMcom	Case=Abl|Numb=Sing
delibutas	delibuo	VER	Numb=Plur|Gend=Fem|Mood=Par|Tense=Perf|Voice=Pass|Person=2
fœde	foede	ADV	Deg=Pos
divexarier	diuexo	VER	Mood=Inf|Tense=Pres|Voice=Pass
age	age	INJ	MORPH=empty
,	,	PUNC	MORPH=empty
adsta	asto	VER	Numb=Sing|Mood=Imp|Tense=Pres|Voice=Act|Person=2
,	,	PUNC	MORPH=empty
mane	mane2	ADV	Deg=Pos|Mood=Imp|Tense=Pres|Voice=Act
,	,	PUNC	MORPH=empty
audi	audio	VER	Numb=Sing|Mood=Imp|Tense=Pres|Voice=Act|Person=2
!	!	PUNC	MORPH=empty
Iteradum	itero	VER	Numb=Sing|Mood=Par|Tense=Perf|Voice=Pass
eadem	idem	PROdem	Case=Nom|Numb=Sing|Gend=Fem
istæc	istic1	PROdem	Case=Nom|Numb=Sing|Gend=Fem
mihi	ego	PROper	Case=Dat|Numb=Sing
.	.	PUNC	MORPH=empty
.	.	PUNC	MORPH=empty
.	.	PUNC	MORPH=empty
quos	qui1	PROrel	Case=Acc|Numb=Plur|Gend=Masc
ego	ego	PROper	Case=Nom|Numb=Sing
,	,	PUNC	MORPH=empty
ita	ita	ADV	Deg=Pos
ut	ut1	ADVrel	MORPH=empty
volui	uolo3	VER	Numb=Sing|Mood=Ind|Tense=Perf|Voice=Act|Person=1
offendo	offendo	VER	Numb=Sing|Mood=Ind|Tense=Pres|Voice=Act|Person=1
incolumnis	incolumna	ADJqua	Case=Dat|Numb=Plur|Deg=Pos
.	.	PUNC	MORPH=empty
.	.	PUNC	MORPH=empty
.	.	PUNC	MORPH=empty
ne	ne4	CONsub	MORPH=empty
porro	porro	ADV	Deg=Pos
te	tu	PROper	Case=Acc|Numb=Sing
error	error	NOMcom	Case=Nom|Numb=Sing
,	,	PUNC	MORPH=empty
qui	qui1	PROrel	Case=Nom|Numb=Sing|Gend=Masc
nunc	nunc	ADV	Deg=Pos
lactat	lacto	VER	Numb=Sing|Mood=Ind|Tense=Pres|Voice=Act|Person=3
,	,	PUNC	MORPH=empty
maceret	macero	VER	Numb=Sing|Mood=Sub|Tense=Pres|Voice=Act|Person=3
profecto	profecto	ADV	Deg=Pos
aut	aut	CONcoo	MORPH=empty
inibi	inibi	ADV	Deg=Pos
est	sum1	VER	Numb=Sing|Mood=Ind|Tense=Pres|Voice=Act|Person=3
aut	aut	CONcoo	MORPH=empty
iam	iam	ADV	Deg=Pos
potiuntur	potior	VER	Numb=Plur|Mood=Ind|Tense=Pres|Voice=Dep|Person=3
Phrygum	Phryx	NOMpro	Case=Gen|Numb=Plur
di	deus	NOMcom	Case=Nom|Numb=Plur
me	ego	PROper	Case=Acc|Numb=Sing
etsi	etsi2	CONsub	MORPH=empty
perdunt	perdo	VER	Numb=Plur|Mood=Ind|Tense=Pres|Voice=Act|Person=3
,	,	PUNC	MORPH=empty
tamen	tamen	ADV	Deg=Pos
esse	sum1	VER	Mood=Inf|Tense=Pres|Voice=Act
adiutam	adiuuo	VER	Case=Acc|Numb=Sing|Gend=Fem|Mood=Par|Tense=Perf|Voice=Pass
expetunt	expeto	VER	Numb=Plur|Mood=Ind|Tense=Pres|Voice=Act|Person=3
quom	cum3	CONsub	MORPH=empty
prius	prius	ADJadv.ord	Deg=Comp
quam	quam1	ADVrel	MORPH=empty
intereo	intereo1	VER	Numb=Sing|Mood=Ind|Tense=Pres|Voice=Act|Person=1
spatium	spatium	NOMcom	Case=Acc|Numb=Sing
ulciscendi	ulciscor	VER	Case=Gen|Numb=Sing|Mood=Ger|Voice=Act
danunt	dano	VER	Numb=Plur|Mood=Ind|Tense=Pres|Voice=Act|Person=3
fac	facio	VER	Numb=Sing|Mood=Imp|Tense=Pres|Voice=Act|Person=2
,	,	PUNC	MORPH=empty
ut	ut1	ADVrel	MORPH=empty
cœpisti	coepio	VER	Numb=Sing|Mood=Ind|Tense=Perf|Voice=Act|Person=2
,	,	PUNC	MORPH=empty
hanc	hic1	PROdem	Case=Acc|Numb=Sing|Gend=Fem
operam	opera	NOMcom	Case=Acc|Numb=Sing
mihi	ego	PROper	Case=Dat|Numb=Sing
des	do	VER	Numb=Sing|Mood=Sub|Tense=Pres|Voice=Act|Person=2
perpetem	perpes	VER	Case=Acc|Numb=Sing|Deg=Pos
:	:	PUNC	MORPH=empty
oculis	oculus	NOMcom	Case=Abl|Numb=Plur
traxerim	traho	VER	Numb=Sing|Mood=Sub|Tense=Perf|Voice=Act|Person=1
Ibo	eo1	VER	Numb=Sing|Mood=Ind|Tense=Fut|Voice=Act|Person=1
ad	ad2	PRE	MORPH=empty
eam	is	PROdem	Case=Acc|Numb=Sing|Gend=Fem
ut	ut4	CONsub	MORPH=empty
sciscam	scisco	VER	Numb=Sing|Mood=Sub|Tense=Pres|Voice=Act|Person=1
quid	quis1	PROint	Case=Acc|Numb=Sing|Gend=Neut
velit	uolo3	VER	Numb=Sing|Mood=Sub|Tense=Pres|Voice=Act|Person=3
.	.	PUNC	MORPH=empty
—	—	PUNC	MORPH=empty
Valvæ	ualuae	NOMcom	Case=Nom|Numb=Plur
sonunt	sono1	VER	Numb=Plur|Mood=Ind|Tense=Pres|Voice=Act|Person=3
.	.	PUNC	MORPH=empty
Occidisti	occido2	VER	Numb=Sing|Mood=Ind|Tense=Perf|Voice=Act|Person=2
!	!	PUNC	MORPH=empty
Ut	ut4	CONsub	MORPH=empty
multa	multus	ADJqua	Case=Acc|Numb=Plur|Gend=Neut|Deg=Pos
paucis	paucus	ADJqua	Case=Abl|Numb=Plur|Deg=Pos
verba	uerbum	NOMcom	Case=Acc|Numb=Plur
unose	unus	ADV	Case=Abl|Numb=Sing
obnuntiem	obnuntio	VER	Numb=Sing|Mood=Sub|Tense=Pres|Voice=Act|Person=1
.	.	PUNC	MORPH=empty
Cur	cur	ADVint	MORPH=empty
inlaqueetur	illaqueo2	VER	Numb=Sing|Mood=Ind|Tense=Fut|Voice=Dep|Person=3
hic	hic2	ADV	Numb=Sing|Gend=Masc
?	?	PUNC	MORPH=empty
—	—	PUNC	MORPH=empty
Mecum	ego	PROper	Case=Abl|Numb=Sing
{Mecum}	cum3	CON	MORPH=empty
altercas	alterco	NOMcom	Case=Acc|Numb=Plur
?	?	PUNC	MORPH=empty
Tace	taceo	VER	Numb=Sing|Mood=Imp|Tense=Pres|Voice=Act|Person=2
!	!	PUNC	MORPH=empty
repugnanti	repugno	VER	Case=Dat|Numb=Sing|Gend=Com|Mood=Par|Tense=Pres|Voice=Act
ego	ego	PROper	Case=Nom|Numb=Sing
porro	porro	ADV	Deg=Pos
hunc	hic1	PROdem	Case=Acc|Numb=Sing|Gend=Masc
vi	uis	NOMcom	Case=Abl|Numb=Sing
detraxi	detraho	VER	Numb=Sing|Mood=Ind|Tense=Perf|Voice=Act|Person=1
ungulum	ungulus	NOMcom	Case=Acc|Numb=Sing
usi	utor	VER	Numb=Plur|Gend=Masc|Mood=Par|Tense=Perf|Voice=Dep
honore	honor	NOMcom	Case=Abl|Numb=Sing
,	,	PUNC	MORPH=empty
credo	credo	VER	Numb=Sing|Mood=Ind|Tense=Pres|Voice=Act|Person=1
,	,	PUNC	MORPH=empty
Achivi	Achiui	NOMpro	Case=Nom|Numb=Plur
hunc	hic1	PROdem	Case=Acc|Numb=Sing|Gend=Masc
sceptrum	sceptrum	NOMcom	Case=Acc|Numb=Sing
patientur	patior	VER	Numb=Plur|Mood=Sub|Tense=Pres|Voice=Dep|Person=3
poti	poto	VER	Mood=Inf|Tense=Pres|Voice=Dep
quis	quis1	PROint	Case=Nom|Numb=Sing|Gend=MascFem
deos	deus	NOMcom	Case=Acc|Numb=Plur
infernos	infernus	ADJqua	Case=Acc|Numb=Plur|Gend=Masc|Deg=Pos
,	,	PUNC	MORPH=empty
quibus	qui1	PROrel	Case=Abl|Numb=Plur|Gend=Com
cælestis	caelestis	ADJqua	Case=Nom|Numb=Sing|Gend=Com|Deg=Pos
dignet	digno	VER	Numb=Sing|Mood=Sub|Tense=Pres|Voice=Act|Person=3
decorare	decoro	VER	Mood=Inf|Tense=Pres|Voice=Act
hostiis	hostia	NOMcom	Case=Abl|Numb=Plur
?	?	PUNC	MORPH=empty
pælici	pellex	NOMcom	Case=Dat|Numb=Sing
superstitiosæ	superstitiosus	ADJqua	Case=Nom|Numb=Sing|Gend=Fem|Deg=Pos
cum	cum2	PRE	MORPH=empty
vecordi	uecors	ADJqua	Case=Abl|Numb=Sing|Gend=Com|Deg=Pos
conjuge	coniux	NOMcom	Case=Abl|Numb=Sing
.	.	PUNC	MORPH=empty
.	.	PUNC	MORPH=empty
.	.	PUNC	MORPH=empty
te	tu	PROper	Case=Acc|Numb=Sing
,	,	PUNC	MORPH=empty
Sol	sol	NOMcom	Case=Voc|Numb=Sing
,	,	PUNC	MORPH=empty
invoco	inuoco	VER	Numb=Sing|Mood=Ind|Tense=Pres|Voice=Act|Person=1
,	,	PUNC	MORPH=empty
ut	ut4	CONsub	MORPH=empty
mihi	ego	PROper	Case=Dat|Numb=Sing
potestatem	potestas	NOMcom	Case=Acc|Numb=Sing
duis	duo	ADJcar	Case=Dat|Numb=Plur|Gend=Com
inquirendi	inquiro	VER	Case=Gen|Numb=Sing|Gend=MascNeut|Mood=Adj|Voice=Pass
mei	meus	PROpos	Case=Gen|Numb=Sing|Gend=MascNeut
parentis	parens1	NOMcom	Case=Gen|Numb=Sing
.	.	PUNC	MORPH=empty
.	.	PUNC	MORPH=empty
.	.	PUNC	MORPH=empty
quæ	quis1	PROint	Case=Nom|Numb=Sing|Gend=Fem
res	res	NOMcom	Case=Nom|Numb=Sing
te	tu	PROper	Case=Acc|Numb=Sing
ab	ab	PRE	MORPH=empty
stabulis	stabulum	NOMcom	Case=Abl|Numb=Plur
abjugat	abiugo	VER	Numb=Sing|Mood=Ind|Tense=Pres|Voice=Act|Person=3
?	?	PUNC	MORPH=empty
—	—	PUNC	MORPH=empty
Certum	certus	ADJqua	Case=Nom|Numb=Sing|Gend=Neut|Deg=Pos
est	sum1	VER	Numb=Sing|Mood=Ind|Tense=Pres|Voice=Act|Person=3
loqui	loquor	VER	Mood=Inf|Tense=Pres|Voice=Dep
.	.	PUNC	MORPH=empty
.	.	PUNC	MORPH=empty
ques	quis1	PROint	Case=Nom|Numb=Plur|Gend=Masc
sunt	sum1	VER	Numb=Plur|Mood=Ind|Tense=Pres|Voice=Act|Person=3
is	is	PROdem	Case=Nom|Numb=Sing|Gend=Masc
?	?	PUNC	MORPH=empty
—	—	PUNC	MORPH=empty
Ignoti	ignotus	ADJqua	Case=Nom|Numb=Plur|Gend=Masc|Deg=Pos
,	,	PUNC	MORPH=empty
nescio	nescio	VER	Numb=Sing|Mood=Ind|Tense=Pres|Voice=Act|Person=1
ques	quis1	PROrel	Case=Nom|Numb=Plur|Gend=Masc
ignobiles	ignobilis	ADJqua	Case=Acc|Numb=Plur|Gend=MascFem|Deg=Pos
acessi	acedo	VER	Numb=Sing|Mood=Ind|Tense=Perf|Voice=Act|Person=1
Æaeam	aeaeus	ADJqua	Case=Acc|Numb=Sing|Gend=Fem|Deg=Pos
,	,	PUNC	MORPH=empty
et	et2	CONcoo	MORPH=empty
tonsillam	tonsilla	ADJqua	Case=Acc|Numb=Sing|Gend=Fem|Deg=Pos
pegi	pex	VER	Numb=Sing
læto	laetus2	ADJqua	Case=Abl|Numb=Sing|Gend=MascNeut|Deg=Pos
in	in	PRE	MORPH=empty
litore	litus	NOMcom	Case=Abl|Numb=Sing
diversi	diuersus	ADJqua	Case=Nom|Numb=Plur|Gend=Masc|Deg=Pos
circumspicimus	circumspicio	VER	Numb=Plur|Mood=Ind|Tense=Pres|Voice=Act|Person=1
,	,	PUNC	MORPH=empty
horror	horror	NOMcom	Case=Nom|Numb=Sing
percipit	percipio	VER	Numb=Sing|Mood=Ind|Tense=Pres|Voice=Act|Person=3
clamore	clamor	NOMcom	Case=Abl|Numb=Sing
et	et2	CONcoo	MORPH=empty
sonitu	sonitus	NOMcom	Case=Abl|Numb=Sing
colles	collis	NOMcom	Case=Nom|Numb=Plur
resonantes	resono1	VER	Case=Nom|Numb=Plur|Gend=MascFem|Mood=Par|Tense=Pres|Voice=Act
bount	bosco	VER	Numb=Plur|Mood=Ind|Tense=Pres|Voice=Act|Person=3
Qui	qui1	PROrel	Case=Nom|Numb=Plur|Gend=Masc
tandem	tandem	ADV	Deg=Pos
?	?	PUNC	MORPH=empty
ubi	ubi2	ADVint	MORPH=empty
ea	is	PROdem	Case=Nom|Numb=Sing|Gend=Fem
est	sum1	VER	Numb=Sing|Mood=Ind|Tense=Pres|Voice=Act|Person=3
?	?	PUNC	MORPH=empty
quod	qui1	PROrel	Case=Acc|Numb=Sing|Gend=Neut
receptat	recepto	VER	Numb=Sing|Mood=Ind|Tense=Pres|Voice=Act|Person=3
?	?	PUNC	MORPH=empty
—	—	PUNC	MORPH=empty
Exul	exsul	NOMcom	Case=Nom|Numb=Sing
incerta	incertus	ADJqua	Case=Acc|Numb=Plur|Gend=Fem|Deg=Pos
vagat	uagor2	VER	Numb=Sing|Mood=Ind|Tense=Pres|Voice=Act|Person=3
?	?	PUNC	MORPH=empty
Cedo	cedo2	INJ	MORPH=empty
quorsum	quorsum	ADVint	MORPH=empty
itiner	iter	NOMcom	Case=Nom|Numb=Sing
tetinisse	tengo	VER	Mood=Inf|Tense=Perf|Voice=Act
aiunt	aio	VER	Numb=Plur|Mood=Ind|Tense=Pres|Voice=Act|Person=3
!	!	PUNC	MORPH=empty
custodite	custodio	VER	Numb=Plur|Mood=Imp|Tense=Pres|Voice=Act|Person=2
istunc	istic1	PROdem	Case=Acc|Numb=Sing|Gend=Masc
vos	uos	PROper	Case=Acc|Numb=Plur
,	,	PUNC	MORPH=empty
ne	ne4	CONsub	MORPH=empty
vim	uis	NOMcom	Case=Acc|Numb=Sing
qui	qui1	PROrel	Case=Nom|Numb=Sing|Gend=Masc
attolat	attolo	VER	Numb=Sing|Mood=Ind|Tense=Pres|Voice=Act|Person=3
neve	neue2	CONsub	MORPH=empty
attigat	attingo	VER	Numb=Sing|Mood=Ind|Tense=Pres|Voice=Act|Person=3
linguæ	lingua	NOMcom	Case=Gen|Numb=Sing
bisulcis	bisulcus	ADJqua	Case=Gen|Numb=Sing|Gend=Com|Deg=Pos
actu	actus1	NOMcom	Case=Abl|Numb=Sing
crispo	crispus	NOMcom	Case=Abl|Numb=Sing
fulgere	fulgeo	VER	Mood=Inf|Tense=Pres|Voice=Act
mulier	mulier	NOMcom	Case=Voc|Numb=Sing
egregiissima	egregius	ADJqua	Case=Abl|Numb=Sing|Gend=Fem|Deg=Sup
forma	forma	NOMcom	Case=Abl|Numb=Sing
cælitum	caeles1	NOMcom	Case=Gen|Numb=Plur
camilla	camilla	NOMcom	Case=Nom|Numb=Sing
,	,	PUNC	MORPH=empty
expectata	exspecto	VER	Case=Abl|Numb=Sing|Gend=Fem|Mood=Par|Tense=Perf|Voice=Pass
advenis	aduenio	VER	Case=Abl|Numb=Sing|Mood=Ind|Tense=Pres|Voice=Act|Person=2
:	:	PUNC	MORPH=empty
salve	salueo	VER	Numb=Sing|Mood=Imp|Tense=Pres|Voice=Act|Person=2
,	,	PUNC	MORPH=empty
hospita	hospita	NOMcom	Case=Abl|Numb=Sing|Deg=Pos
!	!	PUNC	MORPH=empty
possum	possum1	VER	Numb=Sing|Mood=Ind|Tense=Pres|Voice=Act|Person=1
ego	ego	PROper	Case=Nom|Numb=Sing
istam	iste	PROdem	Case=Acc|Numb=Sing|Gend=Fem
capite	caput	NOMcom	Case=Abl|Numb=Sing
cladem	clades	NOMcom	Case=Acc|Numb=Sing
averruncassere	auerrunco	VER	Numb=Plur|Mood=Ind|Tense=Perf|Voice=Act|Person=2
Qua	qui1	PROrel	Case=Abl|Numb=Sing|Gend=Fem
super	super2	PRE	MORPH=empty
re	res	NOMcom	Case=Abl|Numb=Sing
interfectum	interficio	VER	Case=Acc|Numb=Sing|Gend=MascNeut|Mood=Par|Tense=Perf|Voice=Pass
esse	sum1	VER	Mood=Inf|Tense=Pres|Voice=Act
dixisti	dico2	VER	Numb=Sing|Mood=Ind|Tense=Perf|Voice=Act|Person=2
Hippotem	hippotes	NOMcom	Case=Acc|Numb=Sing
?	?	PUNC	MORPH=empty
atque	atque1	CONcoo	MORPH=empty
eccum	ecce	INJ	MORPH=empty
in	in	PRE	MORPH=empty
ipso	ipse	PROdem	Case=Abl|Numb=Sing|Gend=MascNeut
tempore	tempus1	NOMcom	Case=Abl|Numb=Sing
ostentum	ostentum	VER	Case=Acc|Numb=Sing|Gend=Neut|Mood=Par|Tense=Perf|Voice=Pass
senem	senex2	ADJqua	Case=Acc|Numb=Sing|Gend=MascFem
vitam	uita	NOMcom	Case=Acc|Numb=Sing
propagans	propago2	VER	Case=Nom|Numb=Sing|Gend=Com|Mood=Par|Tense=Pres|Voice=Act
†	†	PUNC	MORPH=empty
exan * * †	?	OUT	MORPH=empty
altaribus	altar	NOMcom	Case=Abl|Numb=Plur
sentio	sentio	VER	Numb=Sing|Mood=Ind|Tense=Pres|Voice=Act|Person=1
,	,	PUNC	MORPH=empty
pater	pater	NOMcom	Case=Voc|Numb=Sing
,	,	PUNC	MORPH=empty
te	tu	PROper	Case=Acc|Numb=Sing
vocis	uox	NOMcom	Case=Gen|Numb=Sing
calui	caluor	VER	Mood=Inf|Tense=Pres|Voice=Act
similitudine	similitudo	NOMcom	Case=Abl|Numb=Sing
quis	quis1	PROint	Case=Nom|Numb=Sing|Gend=MascFem
tu	tu	PROper	Case=Nom|Numb=Sing
es	sum1	VER	Numb=Sing|Mood=Ind|Tense=Pres|Voice=Act|Person=2
,	,	PUNC	MORPH=empty
mulier	mulier	NOMcom	Case=Voc|Numb=Sing
,	,	PUNC	MORPH=empty
quæ	qui1	PROrel	Case=Nom|Numb=Sing|Gend=Fem
me	ego	PROper	Case=Acc|Numb=Sing
insveto	insuetus	ADJqua	Case=Abl|Numb=Sing|Gend=MascNeut|Deg=Pos
nuncupasti	nuncupo	VER	Numb=Sing|Mood=Ind|Tense=Perf|Voice=Act|Person=2
nomine	nomen	NOMcom	Case=Abl|Numb=Sing
?	?	PUNC	MORPH=empty
set	sed	CONcoo	MORPH=empty
quid	quis1	PROint	Case=Acc|Numb=Sing|Gend=Neut
conspicio	conspicio	VER	Numb=Sing|Mood=Ind|Tense=Pres|Voice=Act|Person=1
?	?	PUNC	MORPH=empty
num	num	ADVint	MORPH=empty
me	ego	PROper	Case=Acc|Numb=Sing
lactans	lacto	VER	Case=Nom|Numb=Sing|Gend=Com|Mood=Par|Tense=Pres|Voice=Act
calvitur	caluor	VER	Numb=Sing|Mood=Ind|Tense=Pres|Voice=Act|Person=3
Ætas	aetas	NOMcom	Case=Nom|Numb=Sing
?	?	PUNC	MORPH=empty
populoque	populus	NOMcom	Case=Dat|Numb=Sing
{populoque}	que	CON	MORPH=empty
ut	ut4	CONsub	MORPH=empty
faustum	faustus	ADJqua	Case=Acc|Numb=Sing|Gend=MascNeut|Deg=Pos
sempiterne	sempiter	ADV	Deg=Pos
{sempiterne}	ne2	ADV	MORPH=empty
sospitent	sospito	VER	Numb=Plur|Mood=Sub|Tense=Pres|Voice=Act|Person=3
repudio	repudium	NOMcom	Case=Abl|Numb=Sing
auspicium	auspicium	NOMcom	Case=Nom|Numb=Sing
:	:	PUNC	MORPH=empty
regrediundum	regredior	VER	Case=Nom|Numb=Sing|Gend=Neut|Mood=Adj|Voice=Pass
est	sum1	VER	Numb=Sing|Mood=Ind|Tense=Pres|Voice=Act|Person=3
ilico	illico	ADV	Deg=Pos
si	si2	CONsub	MORPH=empty
resto	restum	VER	Numb=Sing
,	,	PUNC	MORPH=empty
†	†	PUNC	MORPH=empty
pergitur	pergo	VER	Numb=Sing|Mood=Ind|Tense=Pres|Voice=Pass|Person=3
†	†	PUNC	MORPH=empty
eam	is	PROdem	Case=Acc|Numb=Sing|Gend=Fem
;	;	PUNC	MORPH=empty
si	si2	CONsub	MORPH=empty
ire	eo1	VER	Mood=Inf|Tense=Pres|Voice=Act
conor	conor	VER	Numb=Sing|Mood=Ind|Tense=Pres|Voice=Dep|Person=1
,	,	PUNC	MORPH=empty
prohibet	prohibeo	VER	Numb=Sing|Mood=Ind|Tense=Pres|Voice=Act|Person=3
bætere	beto	VER	Mood=Inf|Tense=Pres|Voice=Act
neque	neque	CONcoo	MORPH=empty
profundum	profundus	NOMcom	Case=Acc|Numb=Sing
Cedo	cedo1	VER	MORPH=empty
tuum	tuus	PROpos	Case=Acc|Numb=Sing|Gend=MascNeut
pedem	pes	NOMcom	Case=Acc|Numb=Sing
{	{	PUNC	MORPH=empty
mi	ego	PROpos	Case=Voc|Numb=Sing|Gend=Masc
}	}	PUNC	MORPH=empty
,	,	PUNC	MORPH=empty
lymphis	lympha	NOMcom	Case=Abl|Numb=Plur
flavis	flauus	ADJqua	Case=Abl|Numb=Plur|Gend=Com|Deg=Pos
flavum	flauus	ADJqua	Case=Acc|Numb=Sing|Gend=MascNeut|Deg=Pos
ut	ut4	CONsub	MORPH=empty
pulverem	puluis	NOMcom	Case=Acc|Numb=Sing
manibus	manus1	NOMcom	Case=Abl|Numb=Plur
isdem	idem	PROdem	Case=Abl|Numb=Plur|Gend=Com
,	,	PUNC	MORPH=empty
quibus	qui1	PROrel	Case=Abl|Numb=Plur|Gend=Com
Ulixi	Ulixes	NOMpro	Case=Dat|Numb=Sing
sæpe	saepe	ADV	Deg=Pos
permulsi	permulceo	VER	Numb=Plur|Gend=Masc|Mood=Par|Tense=Perf|Voice=Pass
abluam	abluo	VER	Numb=Sing|Mood=Sub|Tense=Pres|Voice=Act|Person=1
lassitudinemque	lassitudo	NOMcom	Case=Acc|Numb=Sing
{lassitudinemque}	que	CON	MORPH=empty
minuam	minuo	VER	Numb=Sing|Mood=Sub|Tense=Pres|Voice=Act|Person=1
manuum	manus1	NOMcom	Case=Gen|Numb=Plur
mollitudine	mollitudo	NOMcom	Case=Abl|Numb=Sing
—	—	PUNC	MORPH=empty
Anticlea	Anticles	NOMpro	Case=Voc|Numb=Sing|Gend=Fem|Deg=Pos
lenitudo	lenitudo	NOMcom	Case=Nom|Numb=Sing
orationis	oratio	NOMcom	Case=Gen|Numb=Sing
,	,	PUNC	MORPH=empty
mollitudo	mollitudo	NOMcom	Case=Nom|Numb=Sing
corporis	corpus	NOMcom	Case=Gen|Numb=Sing
pariter	pariter	ADV	Deg=Pos
te	tu	PROper	Case=Acc|Numb=Sing
esse	sum1	VER	Mood=Inf|Tense=Pres|Voice=Act
erga	erga	PRE	MORPH=empty
illum	ille	PROdem	Case=Acc|Numb=Sing|Gend=Masc
video	uideo	VER	Numb=Sing|Mood=Ind|Tense=Pres|Voice=Act|Person=1
,	,	PUNC	MORPH=empty
ut	ut4	CONsub	MORPH=empty
illum	ille	PROdem	Case=Acc|Numb=Sing|Gend=Masc
ted	tu	PROper	Case=Acc|Numb=Sing
erga	erga	PRE	MORPH=empty
scio	scio	VER	Numb=Sing|Mood=Ind|Tense=Pres|Voice=Act|Person=1
nec	nec2	CONcoo	MORPH=empty
ulla	ullus	PROind	Case=Nom|Numb=Sing|Gend=Fem
subscus	subscus	NOMcom	Case=Nom|Numb=Sing
cohibet	cohibeo	VER	Numb=Sing|Mood=Ind|Tense=Pres|Voice=Act|Person=3
compagem	compages	NOMcom	Case=Acc|Numb=Sing
alvei	alueus	NOMcom	Case=Gen|Numb=Sing
,	,	PUNC	MORPH=empty
sed	sed	CONcoo	MORPH=empty
suta	suo	ADJqua	Case=Nom|Numb=Sing|Gend=Neut|Deg=Pos
lino	linum	NOMcom	Case=Abl|Numb=Sing
et	et2	CONcoo	MORPH=empty
sparteis	sparteus	ADJqua	Case=Abl|Numb=Plur|Deg=Pos
serilibus	serilis	ADJqua	Case=Abl|Numb=Plur|Gend=Com|Deg=Pos
inde	inde	ADV	Deg=Pos
Ætnam	Aetna	NOMpro	Case=Acc|Numb=Sing
montem	mons	NOMcom	Case=Acc|Numb=Sing
advenio	aduenio	VER	Numb=Sing|Mood=Ind|Tense=Pres|Voice=Act|Person=1
in	in	PRE	MORPH=empty
scruposam	scruposus	ADJqua	Case=Acc|Numb=Sing|Gend=Fem|Deg=Pos
specum	specus	NOMcom	Case=Acc|Numb=Sing
quæ	qui1	PROrel	Case=Nom|Numb=Sing|Gend=Fem
meum	meus	PROpos	Case=Acc|Numb=Sing|Gend=MascNeut
venenis	uenenum	NOMcom	Case=Abl|Numb=Plur
flexit	flecto	VER	Numb=Sing|Mood=Ind|Tense=Perf|Voice=Act|Person=3
socium	socius1	NOMcom	Case=Acc|Numb=Sing
pectora	pectus	NOMcom	Case=Acc|Numb=Plur
vos	uos	PROper	Case=Nom|Numb=Plur
hinc	hinc	ADV	Deg=Pos
,	,	PUNC	MORPH=empty
defensum	defendo	VER	Case=Acc|Numb=Sing|Gend=MascNeut|Mood=Par|Tense=Perf|Voice=Pass
patriam	patria	NOMcom	Case=Acc|Numb=Sing
in	in	PRE	MORPH=empty
pugnam	pugna	NOMcom	Case=Acc|Numb=Sing
bætite	baetus	VER	Case=Abl|Numb=Sing|Gend=Masc|Deg=Pos
ætate	aetas	NOMcom	Case=Abl|Numb=Sing
integra	integer	ADJqua	Case=Abl|Numb=Sing|Gend=Fem|Deg=Pos
,	,	PUNC	MORPH=empty
feroci	ferox	ADJqua	Case=Abl|Numb=Sing|Gend=Com|Deg=Pos
ingenio	ingenium	NOMcom	Case=Abl|Numb=Sing
,	,	PUNC	MORPH=empty
facie	facies	NOMcom	Case=Abl|Numb=Sing
procera	procerus	ADJqua	Case=Nom|Numb=Sing|Gend=Fem|Deg=Pos
virum	uir	NOMcom	Case=Acc|Numb=Sing
barbaricam	barbaricus	ADJqua	Case=Acc|Numb=Sing|Gend=Fem|Deg=Pos
pestem	pestis	NOMcom	Case=Acc|Numb=Sing
subinis	subinus	ADJqua	Case=Abl|Numb=Plur|Gend=Com|Deg=Pos
nostris	noster	PROpos	Case=Dat|Numb=Plur|Gend=Com
optulit	offero	VER	Numb=Sing|Mood=Ind|Tense=Perf|Voice=Act|Person=3
,	,	PUNC	MORPH=empty
nova	nouus	ADJqua	Case=Abl|Numb=Sing|Gend=Fem|Deg=Pos
figura	figura	NOMcom	Case=Abl|Numb=Sing
factam	facio	VER	Case=Acc|Numb=Sing|Gend=Fem|Mood=Par|Tense=Perf|Voice=Pass
,	,	PUNC	MORPH=empty
commissam	committo	VER	Case=Acc|Numb=Sing|Gend=Fem|Mood=Par|Tense=Perf|Voice=Pass
infabre	infabre	ADJqua	Deg=Pos
.	.	PUNC	MORPH=empty
—	—	PUNC	MORPH=empty
Ulixes	Ulixes	NOMpro	Case=Nom|Numb=Sing
—	—	PUNC	MORPH=empty
pedetemptim	pedetentim	ADV	Deg=Pos
ac	ac1	CONcoo	MORPH=empty
sedato	sedo	VER	Case=Abl|Numb=Sing|Gend=MascNeut|Mood=Par|Tense=Perf|Voice=Pass
nisu	nisus	NOMcom	Case=Abl|Numb=Sing
,	,	PUNC	MORPH=empty
ne	ne4	CONsub	MORPH=empty
succussu	succussus	NOMcom	Case=Abl|Numb=Sing
arripiat	arripio	VER	Numb=Sing|Mood=Sub|Tense=Pres|Voice=Act|Person=3
maior	magnus	ADJqua	Case=Nom|Numb=Sing|Gend=MascFem|Deg=Comp
Dolor	dolor	NOMcom	Case=Nom|Numb=Sing
{	{	PUNC	MORPH=empty
.	.	PUNC	MORPH=empty
.	.	PUNC	MORPH=empty
.	.	PUNC	MORPH=empty
}	}	PUNC	MORPH=empty
—	—	PUNC	MORPH=empty
Chorus	chorus	NOMcom	Case=Nom|Numb=Sing
—	—	PUNC	MORPH=empty
Tu	tu	PROper	Case=Nom|Numb=Sing
quoque	quoque	ADV	Deg=Pos
,	,	PUNC	MORPH=empty
Ulixes	Ulixes	NOMpro	Case=Nom|Numb=Sing
,	,	PUNC	MORPH=empty
quamquam	quamquam2	CONsub	MORPH=empty
graviter	grauiter	ADV	Deg=Pos
cernimus	cerno	VER	Numb=Plur|Mood=Ind|Tense=Pres|Voice=Act|Person=1
ictum	ictus	NOMcom	Case=Acc|Numb=Sing
,	,	PUNC	MORPH=empty
nimis	nimis	ADV	Deg=Pos
pæne	paene	ADV	Deg=Pos
animo	animus	NOMcom	Case=Abl|Numb=Sing
es	sum1	VER	Numb=Sing|Mood=Ind|Tense=Pres|Voice=Act|Person=2
molli	mollis	ADJqua	Case=Abl|Numb=Sing|Gend=Com|Deg=Pos
,	,	PUNC	MORPH=empty
qui	qui1	PROrel	Case=Nom|Numb=Sing|Gend=Masc
consuetus	consuesco	VER	Numb=Sing|Gend=Masc|Mood=Par|Tense=Perf|Voice=Pass
in	in	PRE	MORPH=empty
armis	arma	NOMcom	Case=Abl|Numb=Plur
Ævom	aeuum	NOMcom	Case=Acc|Numb=Sing
agere	ago	VER	Mood=Inf|Tense=Pres|Voice=Act
{	{	PUNC	MORPH=empty
.	.	PUNC	MORPH=empty
.	.	PUNC	MORPH=empty
.	.	PUNC	MORPH=empty
}	}	PUNC	MORPH=empty
—	—	PUNC	MORPH=empty
Ulixes	Ulixes	NOMpro	Case=Nom|Numb=Sing
—	—	PUNC	MORPH=empty
Retinete	retineo	VER	Numb=Plur|Mood=Imp|Tense=Pres|Voice=Act|Person=2
!	!	PUNC	MORPH=empty
Tenete	teneo	VER	Numb=Plur|Mood=Imp|Tense=Pres|Voice=Act|Person=2
!	!	PUNC	MORPH=empty
Opprimit	opprimo	VER	Numb=Sing|Mood=Ind|Tense=Pres|Voice=Act|Person=3
ulcus	ulcus	NOMcom	Case=Nom|Numb=Sing
!	!	PUNC	MORPH=empty
Nudate	nudo	VER	Numb=Plur|Mood=Imp|Tense=Pres|Voice=Act|Person=2
!	!	PUNC	MORPH=empty
heu	heu	INJ	MORPH=empty
,	,	PUNC	MORPH=empty
miserum	miser	ADJqua	Case=Acc|Numb=Sing|Gend=MascNeut|Deg=Pos
me	ego	PROper	Case=Acc|Numb=Sing
!	!	PUNC	MORPH=empty
excrucior	excrucio	VER	Numb=Sing|Mood=Ind|Tense=Pres|Voice=Pass|Person=1
!	!	PUNC	MORPH=empty
Operite	operio	VER	Numb=Plur|Mood=Imp|Tense=Pres|Voice=Act|Person=2
!	!	PUNC	MORPH=empty
Abscedite	abscedo1	VER	Numb=Plur|Mood=Imp|Tense=Pres|Voice=Act|Person=2
!	!	PUNC	MORPH=empty
iam	iam	ADV	Deg=Pos
iam	iam	ADV	Deg=Pos
{	{	PUNC	MORPH=empty
me	ego	PROper	Case=Acc|Numb=Sing
}	}	PUNC	MORPH=empty
mittite	mitto	VER	Numb=Plur|Mood=Imp|Tense=Pres|Voice=Act|Person=2
:	:	PUNC	MORPH=empty
nam	nam	CONcoo	MORPH=empty
attrectatu	attrectatus	NOMcom	Case=Abl|Numb=Sing
et	et2	CONcoo	MORPH=empty
quassu	quassus1	NOMcom	Case=Abl|Numb=Sing
sævum	saeuus	ADJqua	Case=Acc|Numb=Sing|Gend=MascNeut|Deg=Pos
amplificatis	amplifico	VER	Case=Dat|Numb=Plur|Gend=Com|Mood=Par|Tense=Perf|Voice=Pass
dolorem	dolor	NOMcom	Case=Acc|Numb=Sing
—	—	PUNC	MORPH=empty
Ulixes	Ulixes	NOMpro	Case=Nom|Numb=Sing
—	—	PUNC	MORPH=empty
conqueri	conqueror	VER	Mood=Inf|Tense=Pres|Voice=Dep
fortunam	fortuna	NOMcom	Case=Acc|Numb=Sing
adversam	aduersus1	ADJqua	Case=Acc|Numb=Sing|Gend=Fem|Deg=Pos
,	,	PUNC	MORPH=empty
non	non	ADVneg	MORPH=empty
lamentari	lamentor	VER	Mood=Inf|Tense=Pres|Voice=Pass
decet	decet	VER	Numb=Sing|Mood=Ind|Tense=Pres|Voice=Act|Person=3
:	:	PUNC	MORPH=empty
id	is	PROdem	Case=Nom|Numb=Sing|Gend=Neut
viri	uir	NOMcom	Case=Gen|Numb=Sing
est	sum1	VER	Numb=Sing|Mood=Ind|Tense=Pres|Voice=Act|Person=3
officium	officium	NOMcom	Case=Acc|Numb=Sing
,	,	PUNC	MORPH=empty
fletus	fletus	NOMcom	Case=Gen|Numb=Sing
muliebri	muliebris	ADJqua	Case=Abl|Numb=Sing|Gend=Com|Deg=Pos
ingenio	ingenium	NOMcom	Case=Abl|Numb=Sing
additus	addo	VER	Numb=Sing|Gend=Masc|Mood=Par|Tense=Perf|Voice=Pass
spartam	sparta	NOMcom	Case=Acc|Numb=Sing|Gend=Fem
reportare	reporto	VER	Mood=Inf|Tense=Pres|Voice=Act
instat	insto	VER	Numb=Sing|Mood=Ind|Tense=Pres|Voice=Act|Person=3
,	,	PUNC	MORPH=empty
id	is	PROdem	Case=Acc|Numb=Sing|Gend=Neut
si	si2	CONsub	MORPH=empty
perpetrat	perpetro	VER	Numb=Sing|Mood=Ind|Tense=Pres|Voice=Act|Person=3
eundem	idem	PROdem	Case=Acc|Numb=Sing|Gend=Masc
filios	filius	NOMcom	Case=Acc|Numb=Plur
sibi	sui1	PROref	Case=Dat|Numb=Sing
procreasse	procreo	VER	Mood=Inf|Tense=Perf|Voice=Act
per	per	PRE	MORPH=empty
Calypsonem	Calypso	NOMpro	Case=Acc|Numb=Sing
autumant	autumo	VER	Numb=Plur|Mood=Ind|Tense=Pres|Voice=Act|Person=3
.	.	PUNC	MORPH=empty
.	.	PUNC	MORPH=empty
ardua	arduus	ADJqua	Case=Nom|Numb=Plur|Gend=Neut|Deg=Pos
per	per	PRE	MORPH=empty
loca	locus	NOMcom	Case=Acc|Numb=Plur
agrestia	agrestis2	ADJqua	Case=Acc|Numb=Plur|Gend=Neut|Deg=Pos
cum	cum2	PRE	MORPH=empty
trepidante	trepido	VER	Case=Abl|Numb=Sing|Gend=Com|Mood=Par|Tense=Pres|Voice=Act
gradu	gradus	NOMcom	Case=Abl|Numb=Sing
nititur	nitor2	VER	Numb=Sing|Mood=Ind|Tense=Pres|Voice=Dep|Person=3
.	.	PUNC	MORPH=empty
.	.	PUNC	MORPH=empty
.	.	PUNC	MORPH=empty
.	.	PUNC	MORPH=empty
.	.	PUNC	MORPH=empty
.	.	PUNC	MORPH=empty
corpusque	corpus	NOMcom	Case=Acc|Numb=Sing
{corpusque}	que	CON	MORPH=empty
meum	meus	PROpos	Case=Acc|Numb=Sing|Gend=MascNeut
tali	talis	PROdem	Case=Abl|Numb=Sing|Gend=Com
mærore	maeror	NOMcom	Case=Abl|Numb=Sing
errore	error	NOMcom	Case=Abl|Numb=Sing
macore	macor	NOMcom	Case=Abl|Numb=Sing
senet	seneo	VER	Numb=Sing|Mood=Ind|Tense=Pres|Voice=Act|Person=3
.	.	PUNC	MORPH=empty
.	.	PUNC	MORPH=empty
.	.	PUNC	MORPH=empty
metus	metus	NOMcom	Case=Nom|Numb=Sing
egestas	egestas	NOMcom	Case=Nom|Numb=Sing
mæror	maeror	NOMcom	Case=Nom|Numb=Sing
senium	senium	NOMcom	Case=Acc|Numb=Sing
exiliumque	exsilium	NOMcom	Case=Acc|Numb=Sing
{exiliumque}	que	CON	MORPH=empty
et	et2	CONcoo	MORPH=empty
senectus	senectus1	NOMcom	Case=Nom|Numb=Sing
triplici	triplex	ADJmul	Case=Abl|Numb=Sing|Gend=Com|Deg=Pos
pertimefactus	pertimefacio	VER	Case=Nom|Numb=Sing|Gend=Masc|Mood=Par|Tense=Perf|Voice=Pass
mærore	maeror	NOMcom	Case=Abl|Numb=Sing
animi	animus	NOMcom	Case=Gen|Numb=Sing
incerte	incerte	ADV	Deg=Pos
errans	erro2	VER	Case=Nom|Numb=Sing|Gend=Com|Mood=Par|Tense=Pres|Voice=Act
vagat	uagor2	VER	Numb=Sing|Mood=Ind|Tense=Pres|Voice=Act|Person=3
lapit	lapio	NOMcom	Case=Acc|Numb=Sing
cor	cor	NOMcom	Case=Nom|Numb=Sing
cura	cura	NOMcom	Case=Abl|Numb=Sing
,	,	PUNC	MORPH=empty
ærumna	aerumna	NOMcom	Case=Abl|Numb=Sing
corpus	corpus	NOMcom	Case=Acc|Numb=Sing
conficit	conficio	VER	Numb=Sing|Mood=Ind|Tense=Pres|Voice=Act|Person=3
Parum	parum1	NOMcom	Case=Nom|Numb=Sing
est	sum1	VER	Numb=Sing|Mood=Ind|Tense=Pres|Voice=Act|Person=3
,	,	PUNC	MORPH=empty
quod	quod2	PROrel	Numb=Sing|Gend=Neut
te	tu	PROper	Case=Acc|Numb=Sing
ætas	aetas	NOMcom	Case=Nom|Numb=Sing
male	male	ADV	Deg=Pos
habet	habeo	VER	Numb=Sing|Mood=Ind|Tense=Pres|Voice=Act|Person=3
,	,	PUNC	MORPH=empty
ni	ni2	CONsub	MORPH=empty
etiam	etiam	ADV	Deg=Pos
hunc	hic1	PROdem	Case=Acc|Numb=Sing|Gend=Masc
ad	ad2	PRE	MORPH=empty
malam	malus3	ADJqua	Case=Acc|Numb=Sing|Gend=Fem|Deg=Pos
ætatem	aetas	NOMcom	Case=Acc|Numb=Sing
adjungas	adiungo	VER	Numb=Sing|Mood=Sub|Tense=Pres|Voice=Act|Person=2
cruciatum	cruciatus	NOMcom	Case=Acc|Numb=Sing
reticentia	reticentia	NOMcom	Case=Nom|Numb=Sing
?	?	PUNC	MORPH=empty
mane	maneo	ADV	Deg=Pos|Mood=Imp|Tense=Pres|Voice=Act|Person=2
,	,	PUNC	MORPH=empty
expedibo	expedio	VER	Numb=Sing|Mood=Ind|Tense=Fut|Voice=Act|Person=1
!	!	PUNC	MORPH=empty
Fac	facio	VER	Numb=Sing|Mood=Imp|Tense=Pres|Voice=Act|Person=2
mihi	ego	PROper	Case=Dat|Numb=Sing
contra	contra2	PRE	MORPH=empty
quod	qui1	PROrel	Case=Acc|Numb=Sing|Gend=Neut
rogo	rogo	VER	Numb=Sing|Mood=Ind|Tense=Pres|Voice=Act|Person=1
respondeas	respondeo	VER	Numb=Sing|Mood=Sub|Tense=Pres|Voice=Act|Person=2
!	!	PUNC	MORPH=empty
ecfare	effor	VER	Numb=Sing|Mood=Imp|Tense=Pres|Voice=Act|Person=2
quæ	qui1	PROrel	Case=Acc|Numb=Sing|Gend=Fem
cor	cor	NOMcom	Case=Acc|Numb=Sing
tuum	tuus	PROpos	Case=Acc|Numb=Sing|Gend=MascNeut
timiditas	timiditas	NOMcom	Case=Nom|Numb=Sing
territet	territo	VER	Numb=Sing|Mood=Sub|Tense=Pres|Voice=Act|Person=3
patior	patior	VER	Numb=Sing|Mood=Ind|Tense=Pres|Voice=Dep|Person=1
facile	facile	ADV	Deg=Pos
iniuriam	iniuria	NOMcom	Case=Acc|Numb=Sing
,	,	PUNC	MORPH=empty
si	si2	CONsub	MORPH=empty
est	sum1	VER	Numb=Sing|Mood=Ind|Tense=Pres|Voice=Act|Person=3
vacua	uacuus	ADJqua	Case=Nom|Numb=Sing|Gend=Fem|Deg=Pos
a	ab	PRE	MORPH=empty
contumelia	contumelia	NOMcom	Case=Abl|Numb=Sing
tamen	tamen	ADV	Deg=Pos
obfirmato	obfirmo	VER	Case=Abl|Numb=Sing|Gend=MascNeut|Mood=Par|Tense=Perf|Voice=Pass
animo	animus	NOMcom	Case=Abl|Numb=Sing
,	,	PUNC	MORPH=empty
mitescit	mitesco	VER	Numb=Sing|Mood=Ind|Tense=Pres|Voice=Act|Person=3
metus	metus	NOMcom	Case=Gen|Numb=Sing
gnate	natus1	NOMcom	Case=Abl|Numb=Sing
,	,	PUNC	MORPH=empty
ordinem	ordo	NOMcom	Case=Acc|Numb=Sing
omnem	omnis	PROind	Case=Acc|Numb=Sing|Gend=MascFem
,	,	PUNC	MORPH=empty
ut	ut4	CONsub	MORPH=empty
dederit	do	VER	Numb=Sing|Mood=Ind|Tense=FutAnt|Voice=Act|Person=3
{	{	PUNC	MORPH=empty
se	sui1	PROref	Case=Acc|Numb=Sing
}	}	PUNC	MORPH=empty
,	,	PUNC	MORPH=empty
enoda	enodus	ADJqua	Case=Acc|Numb=Sing|Gend=Fem|Deg=Pos
patri	pater	NOMcom	Case=Dat|Numb=Sing
consternare	consterno1	VER	Mood=Inf|Tense=Pres|Voice=Act
,	,	PUNC	MORPH=empty
anime	animus	NOMcom	Case=Voc|Numb=Sing
!	!	PUNC	MORPH=empty
Ex	ex	PRE	MORPH=empty
pectore	pectus	NOMcom	Case=Abl|Numb=Sing
hac	hic1	PROdem	Case=Abl|Numb=Sing|Gend=Fem
†	†	PUNC	MORPH=empty
!	!	PUNC	MORPH=empty
Et	et2	CONcoo	MORPH=empty
volvere	uoluo	VER	Mood=Inf|Tense=Pres|Voice=Act
consilium	consilium	NOMcom	Case=Acc|Numb=Sing
subito	subito	ADV	Deg=Pos
†	†	PUNC	MORPH=empty
omnes	omnis	PROind	Case=Nom|Numb=Plur|Gend=MascFem
quod	qui1	PROrel	Gend=Neut
†	†	PUNC	MORPH=empty
de	de	PRE	MORPH=empty
nata	nascor	NOMcom	Case=Abl|Numb=Sing|Gend=Fem
est	sum1	VER	Numb=Sing|Mood=Ind|Tense=Pres|Voice=Act|Person=3
modo	modo1	ADV	Deg=Pos
qui	qui1	PROrel	Case=Nom|Numb=Sing|Gend=Masc
pacto	pactum	NOMcom	Case=Abl|Numb=Sing
inimicis	inimicus1	NOMcom	Case=Dat|Numb=Plur
mortem	mors	NOMcom	Case=Acc|Numb=Sing
et	et2	CONcoo	MORPH=empty
huic	hic1	PROdem	Case=Dat|Numb=Sing|Gend=Com
vitam	uita	NOMcom	Case=Acc|Numb=Sing
offeras	offero	VER	Numb=Sing|Mood=Sub|Tense=Pres|Voice=Act|Person=2
nam	nam	CONcoo	MORPH=empty
me	ego	PROper	Case=Acc|Numb=Sing
perbitere	perbito	VER	Mood=Inf|Tense=Pres|Voice=Act
,	,	PUNC	MORPH=empty
illis	ille	PROdem	Case=Dat|Numb=Plur|Gend=Com
opitularier	opitulor	VER	Mood=Ind|Tense=Fut|Voice=Dep
quovis	quiuis	PROind	Case=Abl|Numb=Sing|Gend=MascNeut
exitio	exitium	NOMcom	Case=Abl|Numb=Sing
cupio	cupio	VER	Numb=Sing|Mood=Ind|Tense=Pres|Voice=Act|Person=1
,	,	PUNC	MORPH=empty
dum	dum2	CONsub	MORPH=empty
prosim	prosum1	VER	Numb=Sing|Mood=Sub|Tense=Pres|Voice=Act|Person=1
.	.	PUNC	MORPH=empty
.	.	PUNC	MORPH=empty
non	non	ADVneg	MORPH=empty
potest	possum1	VER	Numb=Sing|Mood=Ind|Tense=Pres|Voice=Act|Person=3
,	,	PUNC	MORPH=empty
Melanippe	Melanippe	NOMpro	Case=Nom|Numb=Sing
,	,	PUNC	MORPH=empty
hic	hic1	PROdem	Gend=Masc
sine	sine	PRE	MORPH=empty
tua	tuus	PROpos	Case=Abl|Numb=Sing|Gend=Fem
opera	opera	NOMcom	Case=Abl|Numb=Sing
exanclari	exanclo	VER	Case=Gen|Numb=Sing|Gend=Com|Mood=Inf|Tense=Pres|Voice=Dep
labos	labor1	NOMcom	Case=Acc|Numb=Sing
postquam	postquam	CONsub	MORPH=empty
est	sum1	VER	Numb=Sing|Mood=Ind|Tense=Pres|Voice=Act|Person=3
oneratus	onero	VER	Case=Nom|Numb=Sing|Gend=Masc|Mood=Par|Tense=Perf|Voice=Pass
frugum	frux	NOMcom	Case=Gen|Numb=Plur
et	et2	CONcoo	MORPH=empty
floris	flos	NOMcom	Case=Gen|Numb=Sing
Liberi	Liber	NOMpro	Case=Nom|Numb=Plur
regnum	regnum	NOMcom	Case=Acc|Numb=Sing
imperator	imperator	NOMcom	Case=Nom|Numb=Sing
,	,	PUNC	MORPH=empty
æternum	aeternus	ADJqua	Case=Nom|Numb=Sing|Gend=MascNeut|Deg=Pos
morum	mos	NOMcom	Case=Gen|Numb=Plur
sator	sator	NOMcom	Case=Nom|Numb=Sing
.	.	PUNC	MORPH=empty
.	.	PUNC	MORPH=empty
.	.	PUNC	MORPH=empty
precor	precor	VER	Numb=Sing|Mood=Ind|Tense=Pres|Voice=Dep|Person=1
veniam	uenia	NOMcom	Case=Acc|Numb=Sing
petens	peto	VER	Case=Nom|Numb=Sing|Gend=Com|Mood=Par|Tense=Pres|Voice=Act
ut	ut4	CONsub	MORPH=empty
quæ	qui1	PROrel	Case=Acc|Numb=Plur|Gend=Neut
egi	ago	VER	Numb=Sing|Mood=Ind|Tense=Perf|Voice=Act|Person=1
ago	ago	VER	Numb=Sing|Mood=Ind|Tense=Pres|Voice=Act|Person=1
axim	axis	NOMcom	Case=Acc|Numb=Sing
verruncent	uerrunco	VER	Numb=Plur|Mood=Ind|Tense=Pres|Voice=Act|Person=3
bene	bene	ADV	Deg=Pos
flexa	flecto	VER	Case=Nom|Numb=Sing|Gend=Neut|Mood=Par|Tense=Perf|Voice=Pass
,	,	PUNC	MORPH=empty
non	non	ADVneg	MORPH=empty
falsa	falsus	ADJqua	Case=Acc|Numb=Plur|Gend=Neut|Deg=Pos
autumare	autumo	VER	Mood=Inf|Tense=Pres|Voice=Act
dictio	dictio	NOMcom	Case=Nom|Numb=Sing
Delfis	Delphi	NOMpro	Case=Nom|Numb=Sing
solet	soleo	VER	Numb=Sing|Mood=Ind|Tense=Pres|Voice=SemDep|Person=3
{	{	PUNC	MORPH=empty
.	.	PUNC	MORPH=empty
.	.	PUNC	MORPH=empty
.	.	PUNC	MORPH=empty
}	}	PUNC	MORPH=empty
.	.	PUNC	MORPH=empty
regnum	regnum	NOMcom	Case=Acc|Numb=Sing
potior	potis	ADJqua	Case=Nom|Numb=Sing|Gend=MascFem|Deg=Comp
,	,	PUNC	MORPH=empty
conjugem	coniux	NOMcom	Case=Acc|Numb=Sing
macto	macto	VER	Case=Abl|Numb=Sing|Gend=MascNeut|Mood=Par|Tense=Perf|Voice=Pass
inferis	inferi	NOMcom	Case=Dat|Numb=Plur
nam	nam	CONcoo	MORPH=empty
si	si2	CONsub	MORPH=empty
te	tu	PROper	Case=Acc|Numb=Sing
regeret	rego	VER	Numb=Sing|Mood=Sub|Tense=Impa|Voice=Act|Person=3
pudor	pudor	NOMcom	Case=Nom|Numb=Sing
,	,	PUNC	MORPH=empty
sive	siue2	CONsub	MORPH=empty
adeo	adeo2	ADV	Deg=Pos
cor	cor	NOMcom	Case=Nom|Numb=Sing
sapientia	sapientia	NOMcom	Case=Nom|Numb=Sing
inbutum	imbuo	VER	Case=Nom|Numb=Sing|Gend=MascNeut|Mood=Par|Tense=Perf|Voice=Pass
foret	sum1	VER	Numb=Sing|Mood=Par|Tense=Fut|Voice=Act
neque	neque	CONcoo	MORPH=empty
tuum	tuus	PROpos	Case=Acc|Numb=Sing|Gend=MascNeut
te	tu	PROper	Case=Acc|Numb=Sing
ingenium	ingenium	NOMcom	Case=Acc|Numb=Sing
moderat	modero	VER	Numb=Sing|Mood=Ind|Tense=Pres|Voice=Act|Person=3
,	,	PUNC	MORPH=empty
neque	neque	CONcoo	MORPH=empty
fraternum	fraternus	ADJqua	Case=Acc|Numb=Sing|Gend=MascNeut|Deg=Pos
ira	ira	NOMcom	Case=Nom|Numb=Sing
exilium	exsilium	NOMcom	Case=Acc|Numb=Sing
levat	leuo1	VER	Numb=Sing|Mood=Ind|Tense=Pres|Voice=Act|Person=3
tu	tu	PROper	Case=Nom|Numb=Sing
,	,	PUNC	MORPH=empty
mulier	mulier	NOMcom	Case=Voc|Numb=Sing
,	,	PUNC	MORPH=empty
tege	tego	VER	Numb=Sing|Mood=Imp|Tense=Pres|Voice=Act|Person=2
te	tu	PROper	Case=Acc|Numb=Sing
et	et2	CONcoo	MORPH=empty
tuta	tutus	ADJqua	Case=Nom|Numb=Sing|Gend=Fem|Deg=Pos
templo	templum	NOMcom	Case=Abl|Numb=Sing
Liberi	Liber	NOMpro	Case=Nom|Numb=Plur
.	.	PUNC	MORPH=empty
.	.	PUNC	MORPH=empty
.	.	PUNC	MORPH=empty
scrupea	scrupeus	ADJqua	Case=Acc|Numb=Sing|Gend=Fem|Deg=Pos
saxea	saxeus	ADJqua	Case=Acc|Numb=Plur|Gend=Neut|Deg=Pos
Bacchi	Bacchus	NOMpro	Case=Gen|Numb=Sing
templa	templum	NOMcom	Case=Acc|Numb=Plur
prope	prope1	ADV	Deg=Pos
aggreditur	aggredior	VER	Numb=Sing|Mood=Ind|Tense=Pres|Voice=Dep|Person=3
.	.	PUNC	MORPH=empty
.	.	PUNC	MORPH=empty
.	.	PUNC	MORPH=empty
.	.	PUNC	MORPH=empty
.	.	PUNC	MORPH=empty
.	.	PUNC	MORPH=empty
thiasantem	thiaso	VER	Case=Acc|Numb=Sing|Gend=MascFem|Mood=Par|Tense=Pres|Voice=Act
fremitu	fremitus	NOMcom	Case=Abl|Numb=Sing
concepi	concipio	VER	Numb=Sing|Mood=Ind|Tense=Perf|Voice=Act|Person=1
melum	melum	NOMcom	Case=Acc|Numb=Sing
belvarum	bellua	NOMcom	Case=Gen|Numb=Plur
†	†	PUNC	MORPH=empty
ac	ac1	CONcoo	MORPH=empty
ferarum	fera	NOMcom	Case=Gen|Numb=Plur
adventus	aduentus	NOMcom	Case=Nom|Numb=Sing
ne	ne4	CONsub	MORPH=empty
tætret	tetero	VER	Numb=Sing|Mood=Sub|Tense=Pres|Voice=Act|Person=3
loca	locus	NOMcom	Case=Acc|Numb=Plur
quamquam	quamquam2	CONsub	MORPH=empty
ætas	aetas	NOMcom	Case=Nom|Numb=Sing
senet	seneo	VER	Numb=Sing|Mood=Sub|Tense=Pres|Voice=Act|Person=3
,	,	PUNC	MORPH=empty
satis	satis2	ADV	Deg=Pos
habeam	habeo	VER	Numb=Sing|Mood=Sub|Tense=Pres|Voice=Act|Person=1
virium	uis	NOMcom	Case=Gen|Numb=Plur
ut	ut4	CONsub	MORPH=empty
te	tu	PROper	Case=Acc|Numb=Sing
ara	ara	NOMcom	Case=Abl|Numb=Sing
arceam	arceo	VER	Numb=Sing|Mood=Sub|Tense=Pres|Voice=Act|Person=1
sed	sed	CONcoo	MORPH=empty
nescio	nescio	VER	Numb=Sing|Mood=Ind|Tense=Pres|Voice=Act|Person=1
quidnam	quisnam	PROint	Case=Nom|Numb=Sing|Gend=Neut
est	sum1	VER	Numb=Sing|Mood=Ind|Tense=Pres|Voice=Act|Person=3
:	:	PUNC	MORPH=empty
†	†	PUNC	MORPH=empty
animi	animus	NOMcom	Case=Gen|Numb=Sing
horrescit	horresco	VER	Numb=Sing|Mood=Ind|Tense=Pres|Voice=Act|Person=3
†	†	PUNC	MORPH=empty
et	et2	CONcoo	MORPH=empty
gliscit	glisco	VER	Numb=Sing|Mood=Ind|Tense=Pres|Voice=Act|Person=3
gaudium	gaudium	NOMcom	Case=Acc|Numb=Sing
o	o	INJ	MORPH=empty
multimodis	multimodis	ADV	Deg=Pos
varie	uarie	ADV	Deg=Pos
dubium	dubius	ADJqua	Case=Acc|Numb=Sing|Gend=MascNeut|Deg=Pos
et	et2	CONcoo	MORPH=empty
prosperum	prosper	ADJqua	Case=Acc|Numb=Sing|Gend=MascNeut|Deg=Pos
copem	cops	NOMcom	Case=Acc|Numb=Sing
diem	dies	NOMcom	Case=Acc|Numb=Sing
!	!	PUNC	MORPH=empty
quæ	qui1	PROrel	Case=Nom|Numb=Sing|Gend=Fem
desiderio	desiderium	NOMcom	Case=Abl|Numb=Sing
alumnum	alumnus1	NOMcom	Case=Acc|Numb=Sing
,	,	PUNC	MORPH=empty
pænitudine	paenitudo	NOMcom	Case=Abl|Numb=Sing
,	,	PUNC	MORPH=empty
squales	squales	NOMcom	Case=Nom|Numb=Plur
scabreque	scabre	ADV	Deg=Pos
{scabreque}	que	CON	MORPH=empty
,	,	PUNC	MORPH=empty
inculta	incultus2	ADJqua	Case=Abl|Numb=Sing|Gend=Fem|Deg=Pos
vastitudine	uastitudo	NOMcom	Case=Abl|Numb=Sing
postquam	postquam	CONsub	MORPH=empty
defessus	defetiscor	VER	Case=Nom|Numb=Sing|Gend=Masc|Deg=Pos|Mood=Par|Tense=Perf|Voice=Dep
perrogitando	perrogito	VER	Case=Abl|Numb=Sing|Mood=Ger|Voice=Act
est	sum1	VER	Numb=Sing|Mood=Ind|Tense=Pres|Voice=Act|Person=3
advenas	aduena	NOMcom	Case=Acc|Numb=Plur
de	de	PRE	MORPH=empty
gnatis	natus1	NOMcom	Case=Abl|Numb=Plur
,	,	PUNC	MORPH=empty
neque	neque	CONcoo	MORPH=empty
quemquam	quisquam	PROind	Case=Acc|Numb=Sing|Gend=MascFem
invenit	inuenio	VER	Numb=Sing|Mood=Ind|Tense=Perf|Voice=Act|Person=3
scium	scium	ADJqua	Case=Acc|Numb=Sing
Quam	quam1	ADVrel	MORPH=empty
te	tu	PROper	Case=Acc|Numb=Sing
post	post1	ADV	Deg=Pos
multis	multus	ADJqua	Case=Abl|Numb=Plur|Gend=Com|Deg=Pos
tueor	tueor	VER	Numb=Sing|Mood=Ind|Tense=Pres|Voice=Dep|Person=1
tempestatibus	tempestas	NOMcom	Case=Abl|Numb=Plur
!	!	PUNC	MORPH=empty
Nihilne	nihil	PROind	Case=Abl
{Nihilne}	ne2	ADV	MORPH=empty
a	ab	PRE	MORPH=empty
Troia	Troia	NOMpro	Case=Abl|Numb=Sing
adportat	apporto	VER	Numb=Sing|Mood=Ind|Tense=Pres|Voice=Act|Person=3
fando	for	VER	Case=Abl|Numb=Sing|Mood=Ger|Voice=Act
?	?	PUNC	MORPH=empty
.	.	PUNC	MORPH=empty
.	.	PUNC	MORPH=empty
.	.	PUNC	MORPH=empty
periere	pereo1	VER	Numb=Plur|Mood=Ind|Tense=Perf|Voice=Act|Person=3
Danai	Danae	NOMpro	Case=Nom|Numb=Plur
:	:	PUNC	MORPH=empty
plera	plerus	ADJqua	Case=Nom|Numb=Plur|Gend=Fem|Deg=Pos
pars	pars	NOMcom	Case=Nom|Numb=Sing
pessumdata	pessumdo	VER	Case=Nom|Numb=Sing|Gend=Fem|Mood=Par|Tense=Perf|Voice=Pass
est	sum1	VER	Numb=Sing|Mood=Ind|Tense=Pres|Voice=Act|Person=3
mihi	ego	PROper	Case=Dat|Numb=Sing
classem	classis	NOMcom	Case=Acc|Numb=Sing
imperat	impero	VER	Numb=Sing|Mood=Ind|Tense=Pres|Voice=Act|Person=3
Thessalum	Thessalus	NOMpro	Case=Acc|Numb=Sing|Gend=MascNeut|Deg=Pos
nostramque	noster	PROpos	Case=Acc|Numb=Sing|Gend=Fem
{nostramque}	que	CON	MORPH=empty
in	in	PRE	MORPH=empty
altum	altum	NOMcom	Case=Acc|Numb=Sing
ut	ut4	CONsub	MORPH=empty
properiter	properiter	ADV	Deg=Pos
deducerem	deduco	VER	Numb=Sing|Mood=Sub|Tense=Impa|Voice=Act|Person=1
.	.	PUNC	MORPH=empty
.	.	PUNC	MORPH=empty
.	.	PUNC	MORPH=empty
profectione	profectio	NOMcom	Case=Abl|Numb=Sing
læti	laetus2	ADJqua	Case=Gen|Numb=Plur|Gend=Masc|Deg=Pos
piscium	piscis	NOMcom	Case=Gen|Numb=Plur
lasciviam	lasciuia	NOMcom	Case=Acc|Numb=Sing
intuemur	intueor	VER	Numb=Plur|Mood=Ind|Tense=Pres|Voice=Dep|Person=1
nec	nec2	CONcoo	MORPH=empty
tuendi	tueor	VER	Case=Gen|Numb=Sing|Mood=Ger|Voice=Act
capere	capio2	VER	Mood=Inf|Tense=Pres|Voice=Act
satias	satias	NOMcom	Case=Acc|Numb=Plur
potest	possum1	VER	Numb=Sing|Mood=Ind|Tense=Pres|Voice=Act|Person=3
.	.	PUNC	MORPH=empty
Interea	interea	ADV	Deg=Pos
prope	prope1	ADV	Deg=Pos
iam	iam	ADV	Deg=Pos
occidente	occido2	VER	Case=Abl|Numb=Sing|Gend=Com|Mood=Par|Tense=Pres|Voice=Act
sole	sol	NOMcom	Case=Abl|Numb=Sing
inhorrescit	inhorresco	VER	Numb=Sing|Mood=Ind|Tense=Pres|Voice=Act|Person=3
mare	mare	NOMcom	Case=Nom|Numb=Sing
,	,	PUNC	MORPH=empty
tenebrae	tenebrae	NOMcom	Case=Nom|Numb=Plur
conduplicantur	conduplico	VER	Numb=Plur|Mood=Ind|Tense=Pres|Voice=Pass|Person=3
,	,	PUNC	MORPH=empty
noctisque	nox	NOMcom	Case=Gen|Numb=Sing
{noctisque}	que	CON	MORPH=empty
et	et2	CONcoo	MORPH=empty
nimbum	nimbus	NOMcom	Case=Acc|Numb=Sing
occaecat	occaeco	VER	Numb=Sing|Mood=Ind|Tense=Pres|Voice=Act|Person=3
nigror	niger	VER	Case=Nom|Numb=Sing
flamma	flamma	NOMcom	Case=Nom|Numb=Sing
inter	inter	PRE	MORPH=empty
nubes	nubes	NOMcom	Case=Acc|Numb=Plur
coruscat	corusco	VER	Numb=Sing|Mood=Ind|Tense=Pres|Voice=Act|Person=3
,	,	PUNC	MORPH=empty
cælum	caelum1	NOMcom	Case=Acc|Numb=Sing
tonitru	tonitrus	NOMcom	Case=Abl|Numb=Sing
contremit	contremo	VER	Numb=Sing|Mood=Ind|Tense=Pres|Voice=Act|Person=3
,	,	PUNC	MORPH=empty
grando	grando	NOMcom	Case=Abl|Numb=Sing
mixta	misceo	VER	Case=Abl|Numb=Sing|Gend=Fem|Mood=Par|Tense=Perf|Voice=Pass
imbri	imber	NOMcom	Case=Abl|Numb=Sing
largifico	largificus	ADJqua	Case=Abl|Numb=Sing|Gend=MascNeut|Deg=Pos
subita	subitus	ADJqua	Case=Abl|Numb=Sing|Gend=Fem|Deg=Pos
præcipitans	praecipito	VER	Case=Nom|Numb=Sing|Gend=Com|Mood=Par|Tense=Pres|Voice=Act
cadit	cado	VER	Numb=Sing|Mood=Ind|Tense=Pres|Voice=Act|Person=3
,	,	PUNC	MORPH=empty
undique	undique	ADV	Deg=Pos
omnes	omnis	PROind	Case=Nom|Numb=Plur|Gend=MascFem
venti	uentus	NOMcom	Case=Nom|Numb=Plur
erumpunt	erumpo	VER	Numb=Plur|Mood=Ind|Tense=Pres|Voice=Act|Person=3
,	,	PUNC	MORPH=empty
sævi	saeuus	ADJqua	Case=Nom|Numb=Plur|Gend=Masc|Deg=Pos
existunt	exsisto	VER	Numb=Plur|Mood=Ind|Tense=Pres|Voice=Act|Person=3
turbines	turbo1	NOMcom	Case=Nom|Numb=Plur
,	,	PUNC	MORPH=empty
fervit	feruo	VER	Numb=Sing|Mood=Ind|Tense=Pres|Voice=Act|Person=3
æstu	aestus	NOMcom	Case=Abl|Numb=Sing
pelagus	pelagus	NOMcom	Case=Nom|Numb=Sing
rapide	rapide	ADV	Deg=Pos
,	,	PUNC	MORPH=empty
retro	retro1	ADV	Deg=Pos
citroque	citro	ADV	Case=Abl|Deg=Pos
{citroque}	que	CON	MORPH=empty
percito	percio	VER	Case=Abl|Numb=Sing|Gend=MascNeut|Mood=Par|Tense=Perf|Voice=Pass
æstu	aestus	NOMcom	Case=Abl|Numb=Sing
præcipitem	praeceps2	ADJqua	Case=Acc|Numb=Sing|Gend=MascFem|Deg=Pos
ratem	ratis	NOMcom	Case=Acc|Numb=Sing
reciprocare	recuproco	VER	Mood=Inf|Tense=Pres|Voice=Act
,	,	PUNC	MORPH=empty
undæque	unda	NOMcom	Case=Nom|Numb=Plur
{undæque}	que	CON	MORPH=empty
e	ex	PRE	MORPH=empty
gremiis	gremium	NOMcom	Case=Abl|Numb=Plur
subjectare	subiecto	VER	Mood=Inf|Tense=Pres|Voice=Act
adfligere	affligo	VER	Mood=Inf|Tense=Pres|Voice=Act
navium	nauis	NOMcom	Case=Gen|Numb=Plur
flictus	flictus	NOMcom	Case=Nom|Numb=Sing
,	,	PUNC	MORPH=empty
armamentum	armamentum	NOMcom	Case=Nom|Numb=Sing
stridor	stridor	NOMcom	Case=Nom|Numb=Sing
et	et2	CONcoo	MORPH=empty
rudentum	rudens	NOMcom	Case=Gen|Numb=Plur
sibilus	sibilus1	NOMcom	Case=Nom|Numb=Sing
Ubi	ubi1	ADVrel	MORPH=empty
pœtæ	poeta	NOMcom	Case=Nom|Numb=Plur
pro	pro1	PRE	MORPH=empty
sua	suus	PROpos.ref	Case=Abl|Numb=Sing|Gend=Fem
parte	pars	NOMcom	Case=Abl|Numb=Sing
falsa	falsus	ADJqua	Case=Abl|Numb=Plur|Gend=Fem|Deg=Pos
confictant	confingo	VER	Numb=Plur|Mood=Ind|Tense=Pres|Voice=Act|Person=3
,	,	PUNC	MORPH=empty
canunt	cano	VER	Numb=Plur|Mood=Ind|Tense=Pres|Voice=Act|Person=3
qui	qui1	PROrel	Case=Nom|Numb=Plur|Gend=Masc
causam	causa	NOMcom	Case=Acc|Numb=Sing
humilem	humilis	ADJqua	Case=Acc|Numb=Sing|Gend=MascFem|Deg=Pos
dictis	dictum	NOMcom	Case=Dat|Numb=Plur
amplant	amplo	VER	Numb=Plur|Mood=Ind|Tense=Pres|Voice=Act|Person=3
haud	haud	ADVneg	MORPH=empty
sinam	sino	VER	Numb=Sing|Mood=Ind|Tense=Fut|Voice=Act|Person=1
quidquam	quisquam	PROind	Case=Acc|Numb=Sing|Gend=Neut
profari	profor	VER	Mood=Inf|Tense=Pres|Voice=Dep
prius	prius	ADJadv.ord	Deg=Comp
quam	quam1	ADVrel	MORPH=empty
accepso	accipio	VER	Case=Abl|Numb=Sing|Gend=MascNeut|Mood=Par|Tense=Perf|Voice=Pass
quod	qui1	PROrel	Case=Acc|Numb=Sing|Gend=Neut
peto	peto	VER	Numb=Sing|Mood=Ind|Tense=Pres|Voice=Act|Person=1
profusus	profundo2	VER	Case=Nom|Numb=Sing|Gend=Masc|Mood=Par|Tense=Perf|Voice=Pass
gemitu	gemitus	NOMcom	Case=Abl|Numb=Sing
,	,	PUNC	MORPH=empty
murmuro	murmur	NOMcom	Case=Abl|Numb=Sing
†	†	PUNC	MORPH=empty
occistians	occistians	VER	Case=Nom|Numb=Sing|Gend=Com|Mood=Par|Tense=Pres|Voice=Act
rua	?	OUT	MORPH=empty
†	†	PUNC	MORPH=empty
segregare	segrego	VER	Mood=Inf|Tense=Pres|Voice=Act
abs	ab	PRE	MORPH=empty
te	tu	PROper	Case=Abl|Numb=Sing
ausu	ausus	NOMcom	Case=Abl|Numb=Sing
’	’	PUNC	MORPH=empty
s	sum1	VER	Numb=Sing|Mood=Ind|Tense=Pres|Voice=Act|Person=1
{s}	scribo	VER	MORPH=empty
aut	aut	CONcoo	MORPH=empty
sine	sine	PRE	MORPH=empty
illo	ille	PROdem	Case=Abl|Numb=Sing|Gend=MascNeut
Salaminam	Salamina	NOMpro	Case=Acc|Numb=Sing
ingredi	ingredior	VER	Mood=Inf|Tense=Pres|Voice=Dep
,	,	PUNC	MORPH=empty
neque	neque	CONcoo	MORPH=empty
paternum	paternus	ADJqua	Case=Acc|Numb=Sing|Gend=MascNeut|Deg=Pos
aspectum	aspectus	NOMcom	Case=Acc|Numb=Sing
es	sum1	VER	Numb=Sing|Mood=Ind|Tense=Pres|Voice=Act|Person=2
veritus	uereor	VER	Case=Nom|Numb=Sing|Gend=Masc|Mood=Par|Tense=Perf|Voice=Dep
,	,	PUNC	MORPH=empty
quom	cum3	CONsub	MORPH=empty
ætate	aetas	NOMcom	Case=Abl|Numb=Sing
exacta	exigo	VER	Case=Abl|Numb=Sing|Gend=Fem|Mood=Par|Tense=Perf|Voice=Pass
indigem	indigeo	VER	Numb=Sing|Mood=Sub|Tense=Pres|Voice=Act|Person=1
liberum	liberi	NOMcom	Case=Acc|Numb=Sing|Deg=Pos
lacerasti	lacero	VER	Numb=Sing|Mood=Ind|Tense=Perf|Voice=Act|Person=2
orbasti	orbo	VER	Numb=Sing|Mood=Ind|Tense=Perf|Voice=Act|Person=2
extinxti	exstinguo	VER	Numb=Sing|Gend=Masc|Mood=Par|Tense=Perf|Voice=Pass
,	,	PUNC	MORPH=empty
neque	neque	CONcoo	MORPH=empty
fratris	frater	NOMcom	Case=Gen|Numb=Sing
necis	nex	NOMcom	Case=Gen|Numb=Sing
neque	neque	CONcoo	MORPH=empty
eius	is	PROdem	Case=Gen|Numb=Sing|Gend=Com
gnati	natus1	NOMcom	Case=Gen|Numb=Sing
parvi	paruus2	ADJqua	Case=Gen|Numb=Sing|Deg=Pos
,	,	PUNC	MORPH=empty
qui	qui1	PROrel	Case=Nom|Numb=Sing|Gend=Masc
tibi	tu	PROper	Case=Dat|Numb=Sing
in	in	PRE	MORPH=empty
tutelam	tutela	NOMcom	Case=Acc|Numb=Sing
est	sum1	VER	Numb=Sing|Mood=Ind|Tense=Pres|Voice=Act|Person=3
traditus	trado	VER	Case=Nom|Numb=Sing|Gend=Masc|Mood=Par|Tense=Perf|Voice=Pass
nos	nos	PROper	Case=Nom|Numb=Plur
illum	ille	PROdem	Case=Acc|Numb=Sing|Gend=Masc
interea	interea	ADV	Deg=Pos
proliciendo	prolicio	VER	Case=Abl|Numb=Sing|Gend=MascNeut|Mood=Ger|Voice=Act
propitiaturos	propitio	VER	Case=Acc|Numb=Plur|Gend=Masc|Mood=Par|Tense=Fut|Voice=Act
facul	facul	ADV	Deg=Pos
Remur	reor	VER	Numb=Sing|Mood=Ind|Tense=Pres|Voice=Dep|Person=1
nam	nam	CONcoo	MORPH=empty
Teucrum	Teucer	NOMpro	Case=Gen|Numb=Plur
regi	rex	NOMcom	Case=Dat|Numb=Sing
sapsa	sapsus	ADJqua	Case=Nom|Numb=Sing|Gend=Fem|Deg=Pos
res	res	NOMcom	Case=Nom|Numb=Sing
restibiliet	restibilio	VER	Numb=Sing|Mood=Ind|Tense=Fut|Voice=Act|Person=3
facessite	facesso	VER	Numb=Plur|Mood=Imp|Tense=Pres|Voice=Act|Person=2
omnes	omnis	PROind	Case=Acc|Numb=Plur|Gend=MascFem
hinc	hinc	ADV	Deg=Pos
;	;	PUNC	MORPH=empty
parumper	parumper	ADV	Deg=Pos
tu	tu	PROper	Case=Nom|Numb=Sing
mane	maneo	VER	Numb=Sing|Mood=Imp|Tense=Pres|Voice=Act|Person=2
!	!	PUNC	MORPH=empty
quamquam	quamquam2	CONsub	MORPH=empty
annisque	annus	NOMcom	Case=Abl|Numb=Plur
{annisque}	que	CON	MORPH=empty
et	et2	CONcoo	MORPH=empty
ætate	aetas	NOMcom	Case=Abl|Numb=Sing
hoc	hic1	PROdem	Case=Acc|Numb=Sing|Gend=Neut
corpus	corpus	NOMcom	Case=Acc|Numb=Sing
putret	putro	VER	Numb=Sing|Mood=Sub|Tense=Pres|Voice=Act|Person=3
nisi	nisi	CONsub	MORPH=empty
cœrceo	coerceo	VER	Numb=Sing|Mood=Ind|Tense=Pres|Voice=Act|Person=1
protervitatem	proteruitas	NOMcom	Case=Acc|Numb=Sing
atque	atque1	CONcoo	MORPH=empty
hostio	hostius	NOMcom	Case=Abl|Numb=Sing
ferociam	ferocia	NOMcom	Case=Acc|Numb=Sing
.	.	PUNC	MORPH=empty
.	.	PUNC	MORPH=empty
.	.	PUNC	MORPH=empty
ut	ut1	ADVrel	MORPH=empty
ego	ego	PROper	Case=Nom|Numb=Sing
si	si2	CONsub	MORPH=empty
quisquam	quisquam	PROind	Case=Nom|Numb=Sing|Gend=MascFem
me	ego	PROper	Case=Acc|Numb=Sing
tagit	tago	VER	Numb=Sing|Mood=Ind|Tense=Pres|Voice=Act|Person=3
te	tu	PROper	Case=Acc|Numb=Sing
repudio	repudium	NOMcom	Case=Abl|Numb=Sing
nec	nec2	CONcoo	MORPH=empty
recipio	recipio	VER	Numb=Sing|Mood=Ind|Tense=Pres|Voice=Act|Person=1
:	:	PUNC	MORPH=empty
naturam	natura	NOMcom	Case=Acc|Numb=Sing
ab	ab	PRE	MORPH=empty
dico	dico2	VER	Numb=Sing|Mood=Ind|Tense=Pres|Voice=Act|Person=1
:	:	PUNC	MORPH=empty
facesse	facesso	VER	Numb=Sing|Mood=Imp|Tense=Pres|Voice=Act|Person=2
!	!	PUNC	MORPH=empty
aut	aut	CONcoo	MORPH=empty
me	ego	PROper	Case=Acc|Numb=Sing
occide	occido2	VER	Numb=Sing|Mood=Imp|Tense=Pres|Voice=Act|Person=2
,	,	PUNC	MORPH=empty
illinc	illinc	ADV	Deg=Pos
si	si2	CONsub	MORPH=empty
usquam	usquam	ADV	Deg=Pos
probitam	probito	VER	Numb=Sing|Mood=Sub|Tense=Pres|Voice=Act|Person=1
gradum	gradus	NOMcom	Case=Acc|Numb=Sing
neque	neque	CONcoo	MORPH=empty
perpetrare	perpetro	VER	Mood=Inf|Tense=Pres|Voice=Act
precibus	prex	NOMcom	Case=Dat|Numb=Plur
†	†	PUNC	MORPH=empty
inpetrita	impetritus	VER	Case=Nom|Numb=Sing|Gend=Fem|Deg=Pos
†	†	PUNC	MORPH=empty
quid	quis1	PROint	Case=Nom|Numb=Sing|Gend=Neut
patria	patria	NOMcom	Case=Nom|Numb=Sing
est	sum1	VER	Numb=Sing|Mood=Ind|Tense=Pres|Voice=Act|Person=3
ubicumque	ubicumque1	ADVrel	MORPH=empty
est	sum1	VER	Numb=Sing|Mood=Ind|Tense=Pres|Voice=Act|Person=3
bene	bene	ADV	Deg=Pos
